AAAAAAAGCAT -> AAAAAAGCATT
AAAAAAGCATT -> AAAAAGCATTC
AAAAACTTCTC -> AAAACTTCTCT
AAAAAGCATTC -> AAAAGCATTCC
AAAACATCTTC -> AAACATCTTCT
AAAACTTCTCT -> AAACTTCTCTG
AAAAGCATTCC -> AAAGCATTCCA
AAACACGTTGC -> AACACGTTGCT
AAACAGAGCTG -> AACAGAGCTGC
AAACAGGAAAT -> AACAGGAAATA
AAACAGTTCTT -> AACAGTTCTTC
AAACATCTTCT -> AACATCTTCTC
AAACGGACTGG -> AACGGACTGGT
AAACGGCGGAT -> AACGGCGGATT
AAACGGTAATC -> AACGGTAATCA
AAACTAATGGC -> AACTAATGGCC
AAACTCCGTAG -> AACTCCGTAGC
AAACTTCTCTG -> AACTTCTCTGC
AAAGACGCATT -> AAGACGCATTA
AAAGATTGATG -> AAGATTGATGC
AAAGATTTATT -> AAGATTTATTA
AAAGCATTCCA -> AAGCATTCCAC
AAAGCCCGAGC -> AAGCCCGAGCC
AAAGGGAGAAA -> AAGGGAGAAAT
AAAGTAGACTC -> AAGTAGACTCC
AAAGTCCTGGG -> AAGTCCTGGGT
AAAGTGCGACC -> AAGTGCGACCG
AAATAATGCGT -> AATAATGCGTA
AAATACTAAAT -> AATACTAAATT
AAATAGACTTT -> AATAGACTTTC
AAATCAAGTAT -> AATCAAGTATG
AAATCGTCCCT -> AATCGTCCCTC
AAATGAGCGGT -> AATGAGCGGTG
AAATGCTCTCA -> AATGCTCTCAG
AAATTACCCCC -> AATTACCCCCG
AAATTGACTGG -> AATTGACTGGA
AACAATTAGCA -> ACAATTAGCAT
AACACGTTAAG -> ACACGTTAAGC
AACACGTTGCT -> ACACGTTGCTC
AACAGAGCTGC -> ACAGAGCTGCA
AACAGGAAATA -> ACAGGAAATAA
AACAGTTCTTC -> ACAGTTCTTCT
AACATCCCAGA -> ACATCCCAGAC
AACATCTTCTC -> ACATCTTCTCC
AACATGGAGAG -> ACATGGAGAGA
AACATGTGGAG -> ACATGTGGAGC
AACCTCCGTAG -> ACCTCCGTAGA
AACCTTGAGAT -> ACCTTGAGATG
AACGGACTGGT -> ACGGACTGGTC
AACGGCGGATT -> ACGGCGGATTT
AACGGTAATCA -> ACGGTAATCAG
AACGTAGACCA -> ACGTAGACCAC
AACGTCCTATC -> ACGTCCTATCT
AACGTTTCGTC -> ACGTTTCGTCC
AACGTTTGTTT -> ACGTTTGTTTG
AACTAATGGCC -> ACTAATGGCCT
AACTAGGGCGG -> ACTAGGGCGGA
AACTCCAAATA -> ACTCCAAATAG
AACTCCGTAGC -> ACTCCGTAGCG
AACTGATCACT -> ACTGATCACTG
AACTTCTCTGC -> ACTTCTCTGCC
AAGAAACGGCG -> AGAAACGGCGG
AAGAACGTCCT -> AGAACGTCCTA
AAGAACGTTTG -> AGAACGTTTGT
AAGACAAGGGA -> AGACAAGGGAG
AAGACCGAACT -> AGACCGAACTG
AAGACGCATTA -> AGACGCATTAA
AAGACTTACGC -> AGACTTACGCA
AAGATACTGTC -> AGATACTGTCT
AAGATGGAGTC -> AGATGGAGTCG
AAGATTGATGC -> AGATTGATGCA
AAGATTTATTA -> AGATTTATTAT
AAGCAAGAAAC -> AGCAAGAAACG
AAGCACGTCGC -> AGCACGTCGCG
AAGCATTCCAC -> AGCATTCCACT
AAGCCCGAGCC -> AGCCCGAGCCA
AAGCCCTGGGC -> AGCCCTGGGCC
AAGCCGTCACC -> AGCCGTCACCC
AAGCTAGCCTG -> AGCTAGCCTGG
AAGGCACAGAC -> AGGCACAGACC
AAGGGAGAAAT -> AGGGAGAAATG
AAGGGAGGTTT -> AGGGAGGTTTC
AAGTACCCGAA -> AGTACCCGAAA
AAGTAGACTCC -> AGTAGACTCCT
AAGTATGAATT -> AGTATGAATTC
AAGTCCTCTAT -> AGTCCTCTATC
AAGTCCTGGGT -> AGTCCTGGGTT
AAGTGCGACCG -> AGTGCGACCGG
AAGTGGAAAGT -> AGTGGAAAGTA
AAGTGTGCATA -> AGTGTGCATAC
AAGTGTTCCGA -> AGTGTTCCGAG
AAGTTGCACGG -> AGTTGCACGGA
AATAAAAAAAG -> ATAAAAAAAGC
AATAACATCCC -> ATAACATCCCA
AATAATCATAG -> ATAATCATAGA
AATAATGCGTA -> ATAATGCGTAG
AATAATGTGAG -> ATAATGTGAGA
AATACAGACAC -> ATACAGACACT
AATACGACCGA -> ATACGACCGAC
AATACTAAATT -> ATACTAAATTA
AATAGACTTTC -> ATAGACTTTCA
AATCAAGTATG -> ATCAAGTATGA
AATCAATAACA -> ATCAATAACAT
AATCAGCGGAA -> ATCAGCGGAAT
AATCATAGAAA -> ATCATAGAAAT
AATCGGGACCC -> ATCGGGACCCA
AATCGTCCCTC -> ATCGTCCCTCG
AATCTATCCGG -> ATCTATCCGGG
AATGAGCGGTG -> ATGAGCGGTGT
AATGCAATCAA -> ATGCAATCAAT
AATGCGTAGGG -> ATGCGTAGGGT
AATGCTCTCAG -> ATGCTCTCAGT
AATGGACATAC -> ATGGACATACC
AATGGCCTTTC -> ATGGCCTTTCT
AATGTGAGAGA -> ATGTGAGAGAC
AATTAACACGT -> ATTAACACGTT
AATTAACGTTT -> ATTAACGTTTC
AATTAAGATGG -> ATTAAGATGGA
AATTAAGTGGA -> ATTAAGTGGAA
AATTACCCCCG -> ATTACCCCCGT
AATTAGCATAA -> ATTAGCATAAC
AATTCTCCTTA -> ATTCTCCTTAC
AATTCTTCAGC -> ATTCTTCAGCG
AATTGACTGGA -> ATTGACTGGAA
AATTTAGGGCA -> ATTTAGGGCAT
AATTTATTCGA -> ATTTATTCGAT
ACAAAGCCCGA -> CAAAGCCCGAG
ACAAATCAAGT -> CAAATCAAGTA
ACAAGAACGTC -> CAAGAACGTCC
ACAAGGGAGGT -> CAAGGGAGGTT
ACAATCGGGAC -> CAATCGGGACC
ACAATTAGCAT -> CAATTAGCATA
ACAATTTATTC -> CAATTTATTCG
ACACCCGGCCT -> CACCCGGCCTG
ACACGTTAAGC -> CACGTTAAGCC
ACACGTTGCTC -> CACGTTGCTCA
ACACTACCCGT -> CACTACCCGTA
ACACTGCAAAC -> CACTGCAAACG
ACACTTCGGAT -> CACTTCGGATA
ACAGAAGTGTT -> CAGAAGTGTTC
ACAGAATCTAT -> CAGAATCTATC
ACAGACACTGC -> CAGACACTGCA
ACAGACCTGGC -> CAGACCTGGCG
ACAGAGCTGCA -> CAGAGCTGCAA
ACAGGAAATAA -> CAGGAAATAAT
ACAGGCGTTCT -> CAGGCGTTCTG
ACAGGCTAATA -> CAGGCTAATAA
ACAGGGAAACT -> CAGGGAAACTC
ACAGGGCAGCT -> CAGGGCAGCTA
ACAGTTCTTCT -> CAGTTCTTCTT
ACATACCAGAG -> CATACCAGAGC
ACATAGACAGA -> CATAGACAGAA
ACATCCCAGAC -> CATCCCAGACA
ACATCTTCTCC -> CATCTTCTCCT
ACATGCCCTGT -> CATGCCCTGTA
ACATGGAGAGA -> CATGGAGAGAA
ACATGTGGAGC -> CATGTGGAGCA
ACATTCACATT -> CATTCACATTC
ACATTCCGTCA -> CATTCCGTCAT
ACCAACGTAGA -> CCAACGTAGAC
ACCAATAAAAA -> CCAATAAAAAA
ACCACGTAAAG -> CCACGTAAAGG
ACCACTGGCCG -> CCACTGGCCGT
ACCAGAGCCTA -> CCAGAGCCTAT
ACCAGTAGAGT -> CCAGTAGAGTA
ACCATTTGCGA -> CCATTTGCGAC
ACCCACAGGCG -> CCCACAGGCGT
ACCCACGCTCC -> CCCACGCTCCG
ACCCAGGTGAG -> CCCAGGTGAGC
ACCCCCGTCGG -> CCCCCGTCGGC
ACCCCGTGTAG -> CCCCGTGTAGT
ACCCGAAATTG -> CCCGAAATTGA
ACCCGGCCTGT -> CCCGGCCTGTT
ACCCGGCTTGA -> CCCGGCTTGAA
ACCCGTAGGCC -> CCCGTAGGCCG
ACCCGTATAGC -> CCCGTATAGCA
ACCCTCCCGAG -> CCCTCCCGAGG
ACCCTGGATAG -> CCCTGGATAGC
ACCGAACTGAT -> CCGAACTGATC
ACCGACGGTGT -> CCGACGGTGTA
ACCGGCACTCA -> CCGGCACTCAG
ACCGGGGGACG -> CCGGGGGACGT
ACCTCACTCAG -> CCTCACTCAGT
ACCTCCGTAGA -> CCTCCGTAGAG
ACCTCTTGTAT -> CCTCTTGTATG
ACCTGGCGCAT -> CCTGGCGCATG
ACCTTGAGATG -> CCTTGAGATGA
ACGAAACAGAG -> CGAAACAGAGC
ACGAAAGACGC -> CGAAAGACGCA
ACGAATACGAC -> CGAATACGACC
ACGACCGACGG -> CGACCGACGGT
ACGAGCAGGAA -> CGAGCAGGAAT
ACGAGCATTAT -> CGAGCATTATA
ACGATGTATTA -> CGATGTATTAT
ACGCAAAGATT -> CGCAAAGATTT
ACGCAATACAG -> CGCAATACAGA
ACGCATTAACT -> CGCATTAACTA
ACGCCTTCTGC -> CGCCTTCTGCC
ACGCTCCGCTC -> CGCTCCGCTCA
ACGCTTAAAAA -> CGCTTAAAAAC
ACGCTTACACT -> CGCTTACACTA
ACGGACTGGTC -> CGGACTGGTCT
ACGGATGGACG -> CGGATGGACGC
ACGGCGGATTT -> CGGCGGATTTA
ACGGCGGCGTC -> CGGCGGCGTCA
ACGGGTAGACA -> CGGGTAGACAA
ACGGTAATCAG -> CGGTAATCAGC
ACGGTGTAGAT -> CGGTGTAGATG
ACGTAAAGGGA -> CGTAAAGGGAG
ACGTAGACCAC -> CGTAGACCACT
ACGTCCTATCT -> CGTCCTATCTA
ACGTCGCGGGC -> CGTCGCGGGCT
ACGTGGGCGAC -> CGTGGGCGACT
ACGTTAAGCCC -> CGTTAAGCCCT
ACGTTGCTCAC -> CGTTGCTCACG
ACGTTTCGTCC -> CGTTTCGTCCT
ACGTTTGTTTG -> CGTTTGTTTGT
ACTAAATTACC -> CTAAATTACCC
ACTAATGGCCT -> CTAATGGCCTT
ACTACAGGGCA -> CTACAGGGCAG
ACTACCCGTAT -> CTACCCGTATA
ACTACGCCTTC -> CTACGCCTTCT
ACTAGGGCGGA -> CTAGGGCGGAA
ACTATTATTTT -> CTATTATTTTC
ACTCAGATGCC -> CTCAGATGCCA
ACTCAGCTATC -> CTCAGCTATCA
ACTCAGTCCGG -> CTCAGTCCGGA
ACTCCAAATAG -> CTCCAAATAGA
ACTCCGTAGCG -> CTCCGTAGCGA
ACTCCTGATGG -> CTCCTGATGGC
ACTCGGATGGG -> CTCGGATGGGA
ACTGAGCGTGC -> CTGAGCGTGCA
ACTGATCACTG -> CTGATCACTGG
ACTGATGTATC -> CTGATGTATCG
ACTGCAAACGG -> CTGCAAACGGT
ACTGCCGCGGC -> CTGCCGCGGCC
ACTGGAAGCAA -> CTGGAAGCAAG
ACTGGCCGTCG -> CTGGCCGTCGT
ACTGGTCCAGA -> CTGGTCCAGAC
ACTGGTCTGGT -> CTGGTCTGGTT
ACTGTATGCTG -> CTGTATGCTGT
ACTGTCTTCTG -> CTGTCTTCTGG
ACTGTGCGTAG -> CTGTGCGTAGC
ACTTACGCAAA -> CTTACGCAAAG
ACTTATACACT -> CTTATACACTT
ACTTCGGATAG -> CTTCGGATAGA
ACTTCTCTGCC -> CTTCTCTGCCA
ACTTTCAAGCA -> CTTTCAAGCAC
ACTTTGCGAAA -> CTTTGCGAAAG
ACTTTTACTAC -> CTTTTACTACG
AGAAACGGCGG -> GAAACGGCGGA
AGAAATGAGCG -> GAAATGAGCGG
AGAAATGCTCT -> GAAATGCTCTC
AGAACGTCCTA -> GAACGTCCTAT
AGAACGTTTGT -> GAACGTTTGTT
AGAAGTGTTCC -> GAAGTGTTCCG
AGAAGTTGCAC -> GAAGTTGCACG
AGAATCTATCC -> GAATCTATCCG
AGACAAAGCCC -> GACAAAGCCCG
AGACAAATCAA -> GACAAATCAAG
AGACAAGGGAG -> GACAAGGGAGG
AGACACTGCAA -> GACACTGCAAA
AGACAGAATCT -> GACAGAATCTA
AGACCACTGGC -> GACCACTGGCC
AGACCCCGTGT -> GACCCCGTGTA
AGACCGAACTG -> GACCGAACTGA
AGACCGGCACT -> GACCGGCACTC
AGACCTGGCGC -> GACCTGGCGCA
AGACGAGCAGG -> GACGAGCAGGA
AGACGCAATAC -> GACGCAATACA
AGACGCATTAA -> GACGCATTAAC
AGACGGCGGCG -> GACGGCGGCGT
AGACTCCTGAT -> GACTCCTGATG
AGACTCGGATG -> GACTCGGATGG
AGACTGAGCGT -> GACTGAGCGTG
AGACTTACGCA -> GACTTACGCAA
AGACTTTCAAG -> GACTTTCAAGC
AGAGAAGTTGC -> GAGAAGTTGCA
AGAGACCCCGT -> GAGACCCCGTG
AGAGCCTATCG -> GAGCCTATCGA
AGAGCGTATGG -> GAGCGTATGGC
AGAGCTGCAAC -> GAGCTGCAACA
AGAGCTTCTTA -> GAGCTTCTTAA
AGAGTACTGTG -> GAGTACTGTGC
AGAGTTGGTAC -> GAGTTGGTACA
AGAGTTTTATG -> GAGTTTTATGA
AGATACTGTCT -> GATACTGTCTT
AGATGAAGTAC -> GATGAAGTACC
AGATGCCAATT -> GATGCCAATTA
AGATGGAGTCG -> GATGGAGTCGC
AGATGTGATAT -> GATGTGATATC
AGATTGATGCA -> GATTGATGCAT
AGATTTACTAT -> GATTTACTATT
AGATTTATTAT -> GATTTATTATT
AGCAAATACTA -> GCAAATACTAA
AGCAAGAAACG -> GCAAGAAACGG
AGCAAGACTTA -> GCAAGACTTAC
AGCACCAATAA -> GCACCAATAAA
AGCACGTCGCG -> GCACGTCGCGG
AGCAGCTTATC -> GCAGCTTATCG
AGCAGGAATTA -> GCAGGAATTAA
AGCATAACTCC -> GCATAACTCCA
AGCATAGGGGA -> GCATAGGGGAA
AGCATGTATTG -> GCATGTATTGG
AGCATTATACG -> GCATTATACGA
AGCATTCCACT -> GCATTCCACTG
AGCCACATGCC -> GCCACATGCCC
AGCCACTCAGA -> GCCACTCAGAT
AGCCATCCACA -> GCCATCCACAG
AGCCCGAGCCA -> GCCCGAGCCAC
AGCCCTGGGCC -> GCCCTGGGCCC
AGCCGACAGGG -> GCCGACAGGGA
AGCCGTCACCC -> GCCGTCACCCG
AGCCTATCGAA -> GCCTATCGAAA
AGCCTGGTAAT -> GCCTGGTAATG
AGCGAGGTCGT -> GCGAGGTCGTC
AGCGGAATTAA -> GCGGAATTAAG
AGCGGTGTTAC -> GCGGTGTTACC
AGCGTATGGCA -> GCGTATGGCAG
AGCGTGCATCG -> GCGTGCATCGT
AGCTACCCACA -> GCTACCCACAG
AGCTAGCCTGG -> GCTAGCCTGGT
AGCTATCAAAC -> GCTATCAAACT
AGCTCCACATA -> GCTCCACATAG
AGCTCTCTGCC -> GCTCTCTGCCG
AGCTGCAACAA -> GCTGCAACAAT
AGCTTATCGAG -> GCTTATCGAGG
AGCTTCTGTGG -> GCTTCTGTGGC
AGCTTCTTAAG -> GCTTCTTAAGA
AGGAAATAATG -> GGAAATAATGC
AGGAATTAAGA -> GGAATTAAGAT
AGGACCTCTTG -> GGACCTCTTGT
AGGAGTTCCCT -> GGAGTTCCCTT
AGGCACAGACC -> GGCACAGACCT
AGGCCCGTAGG -> GGCCCGTAGGG
AGGCCCTCGAG -> GGCCCTCGAGG
AGGCCGTAGCA -> GGCCGTAGCAG
AGGCGTTCTGA -> GGCGTTCTGAA
AGGCTAATAAT -> GGCTAATAATC
AGGGAAACTCC -> GGGAAACTCCG
AGGGAATTTAG -> GGGAATTTAGG
AGGGACCCACG -> GGGACCCACGC
AGGGAGAAATG -> GGGAGAAATGC
AGGGAGGTTTC -> GGGAGGTTTCG
AGGGAGTACAT -> GGGAGTACATT
AGGGCAGCTAC -> GGGCAGCTACC
AGGGCATACCA -> GGGCATACCAG
AGGGCGGAATG -> GGGCGGAATGC
AGGGGAAACAC -> GGGGAAACACG
AGGGGAAACAG -> GGGGAAACAGG
AGGGGATTGTC -> GGGGATTGTCA
AGGGTGATGCC -> GGGTGATGCCC
AGGTCGTCCCA -> GGTCGTCCCAC
AGGTGAGCACC -> GGTGAGCACCA
AGGTGGTCCTC -> GGTGGTCCTCG
AGGTTTCGTAC -> GGTTTCGTACG
AGTACATTCAC -> GTACATTCACA
AGTACCCGAAA -> GTACCCGAAAT
AGTACTGTGCG -> GTACTGTGCGT
AGTAGACTCCT -> GTAGACTCCTG
AGTAGAGTACT -> GTAGAGTACTG
AGTAGGAGTTC -> GTAGGAGTTCC
AGTATGAATTC -> GTATGAATTCT
AGTCACTTTTA -> GTCACTTTTAC
AGTCAGGACCT -> GTCAGGACCTC
AGTCCAGCTCC -> GTCCAGCTCCA
AGTCCGGAGAC -> GTCCGGAGACG
AGTCCTAGCAA -> GTCCTAGCAAG
AGTCCTCTATC -> GTCCTCTATCC
AGTCCTGGGTT -> GTCCTGGGTTG
AGTCGCGGAGT -> GTCGCGGAGTG
AGTCGGCTGGG -> GTCGGCTGGGC
AGTCTAAATCG -> GTCTAAATCGT
AGTCTCTACCA -> GTCTCTACCAA
AGTCTCTATCC -> GTCTCTATCCA
AGTGAGACTGA -> GTGAGACTGAG
AGTGCGACCGG -> GTGCGACCGGG
AGTGGAAAGTA -> GTGGAAAGTAG
AGTGTAGAGCG -> GTGTAGAGCGT
AGTGTCCGCTG -> GTGTCCGCTGC
AGTGTGCATAC -> GTGTGCATACT
AGTGTTCCGAG -> GTGTTCCGAGA
AGTTAGTCCAG -> GTTAGTCCAGC
AGTTCCCTTAC -> GTTCCCTTACA
AGTTCTTCTTA -> GTTCTTCTTAG
AGTTGCACGGA -> GTTGCACGGAT
AGTTGGTACAG -> GTTGGTACAGG
AGTTTTATGAA -> GTTTTATGAAG
ATAAAAAAAGC -> TAAAAAAAGCA
ATAACATCCCA -> TAACATCCCAG
ATAACTCCAAA -> TAACTCCAAAT
ATAATAATGTG -> TAATAATGTGA
ATAATCATAGA -> TAATCATAGAA
ATAATGCGTAG -> TAATGCGTAGG
ATAATGTGAGA -> TAATGTGAGAG
ATACACTTCGG -> TACACTTCGGA
ATACAGACACT -> TACAGACACTG
ATACCAGAGCC -> TACCAGAGCCT
ATACCAGTAGA -> TACCAGTAGAG
ATACGAAACAG -> TACGAAACAGA
ATACGACCGAC -> TACGACCGACG
ATACTAAATTA -> TACTAAATTAC
ATACTGTATGC -> TACTGTATGCT
ATACTGTCTTC -> TACTGTCTTCT
ATAGAAATGAG -> TAGAAATGAGC
ATAGACAGAAT -> TAGACAGAATC
ATAGACGAGCA -> TAGACGAGCAG
ATAGACTTTCA -> TAGACTTTCAA
ATAGCATAGGG -> TAGCATAGGGG
ATAGCATGTAT -> TAGCATGTATT
ATAGGGGAAAC -> TAGGGGAAACA
ATATCCAAGAT -> TATCCAAGATA
ATCAAACTAAT -> TCAAACTAATG
ATCAAGTATGA -> TCAAGTATGAA
ATCAATAACAT -> TCAATAACATC
ATCAATTAACA -> TCAATTAACAC
ATCACTGGTCC -> TCACTGGTCCA
ATCAGCGGAAT -> TCAGCGGAATT
ATCATAGAAAT -> TCATAGAAATG
ATCCAAGATAC -> TCCAAGATACT
ATCCACAGAAG -> TCCACAGAAGT
ATCCACGAAAG -> TCCACGAAAGA
ATCCCAGACAA -> TCCCAGACAAA
ATCCCGGAGTC -> TCCCGGAGTCA
ATCCGGGCGCG -> TCCGGGCGCGA
ATCCGGGGGCT -> TCCGGGGGCTT
ATCGAAACGGA -> TCGAAACGGAC
ATCGAGGGACC -> TCGAGGGACCC
ATCGGGACCCA -> TCGGGACCCAG
ATCGGGTACTT -> TCGGGTACTTT
ATCGTCCCTCG -> TCGTCCCTCGA
ATCGTCGCGAG -> TCGTCGCGAGC
ATCGTGGGCCC -> TCGTGGGCCCC
ATCTAGCTTCT -> TCTAGCTTCTG
ATCTATCCGGG -> TCTATCCGGGG
ATCTCTCATCA -> TCTCTCATCAA
ATCTGACCCTG -> TCTGACCCTGG
ATCTGTCAACA -> TCTGTCAACAT
ATCTTCTCCTT -> TCTTCTCCTTT
ATGAAGTACCC -> TGAAGTACCCG
ATGAAGTGTGC -> TGAAGTGTGCA
ATGAATTCTTC -> TGAATTCTTCA
ATGAGCGGTGT -> TGAGCGGTGTT
ATGCAATCAAT -> TGCAATCAATA
ATGCATGCGCT -> TGCATGCGCTC
ATGCCAATTAA -> TGCCAATTAAC
ATGCCCCCTCG -> TGCCCCCTCGA
ATGCCCTGTAA -> TGCCCTGTAAA
ATGCGCTCCCT -> TGCGCTCCCTT
ATGCGTAGGGT -> TGCGTAGGGTG
ATGCTCTCAGT -> TGCTCTCAGTT
ATGCTGTGTCT -> TGCTGTGTCTC
ATGGACATACC -> TGGACATACCA
ATGGACGCTTA -> TGGACGCTTAA
ATGGAGAGAAG -> TGGAGAGAAGT
ATGGAGTCGCG -> TGGAGTCGCGG
ATGGATCCGGG -> TGGATCCGGGC
ATGGCAGGGAA -> TGGCAGGGAAT
ATGGCCTCTAT -> TGGCCTCTATG
ATGGCCTTTCT -> TGGCCTTTCTT
ATGGGATGTAG -> TGGGATGTAGT
ATGGGGTTGGA -> TGGGGTTGGAG
ATGGGTAGACT -> TGGGTAGACTC
ATGGTCGCGGA -> TGGTCGCGGAC
ATGGTTTCGCA -> TGGTTTCGCAC
ATGTAGTCTAA -> TGTAGTCTAAA
ATGTATCGTCG -> TGTATCGTCGC
ATGTATTATGG -> TGTATTATGGG
ATGTATTGGGA -> TGTATTGGGAA
ATGTGAGAGAC -> TGTGAGAGACC
ATGTGATATCC -> TGTGATATCCA
ATGTGGAGCAA -> TGTGGAGCAAA
ATTAACACGTT -> TTAACACGTTA
ATTAACGTTTC -> TTAACGTTTCG
ATTAACTAGGG -> TTAACTAGGGC
ATTAAGATGGA -> TTAAGATGGAG
ATTAAGTGGAA -> TTAAGTGGAAA
ATTACCCCCGT -> TTACCCCCGTC
ATTAGCATAAC -> TTAGCATAACT
ATTATACGAAA -> TTATACGAAAC
ATTATGGGGTT -> TTATGGGGTTG
ATTATTCGTAC -> TTATTCGTACC
ATTATTTTCTT -> TTATTTTCTTA
ATTCACATTCC -> TTCACATTCCG
ATTCCACTGAT -> TTCCACTGATG
ATTCCGTCATT -> TTCCGTCATTT
ATTCGATCTGT -> TTCGATCTGTC
ATTCGTACCAC -> TTCGTACCACG
ATTCTCCTTAC -> TTCTCCTTACA
ATTGACTGGAA -> TTGACTGGAAG
ATTGATGCATG -> TTGATGCATGC
ATTGGGAAGAC -> TTGGGAAGACA
ATTGTCAGTCA -> TTGTCAGTCAC
ATTGTTTCTTT -> TTGTTTCTTTT
ATTTACTATTA -> TTTACTATTAT
ATTTAGGGCAT -> TTTAGGGCATA
ATTTATGGTTT -> TTTATGGTTTC
ATTTATTATTC -> TTTATTATTCG
ATTTATTCGAT -> TTTATTCGATC
ATTTGCGACAA -> TTTGCGACAAT
ATTTGGCGGGT -> TTTGGCGGGTT
ATTTTCTTACG -> TTTTCTTACGA
CAAAACATCTT -> AAAACATCTTC
CAAACGGTAAT -> AAACGGTAATC
CAAACTAATGG -> AAACTAATGGC
CAAAGATTGAT -> AAAGATTGATG
CAAAGATTTAT -> AAAGATTTATT
CAAAGCCCGAG -> AAAGCCCGAGC
CAAATACTAAA -> AAATACTAAAT
CAAATAGACTT -> AAATAGACTTT
CAAATCAAGTA -> AAATCAAGTAT
CAACAATTAGC -> AACAATTAGCA
CAACATGTGGA -> AACATGTGGAG
CAACGTAGACC -> AACGTAGACCA
CAAGAAACGGC -> AAGAAACGGCG
CAAGAACGTCC -> AAGAACGTCCT
CAAGACCGAAC -> AAGACCGAACT
CAAGACTTACG -> AAGACTTACGC
CAAGATACTGT -> AAGATACTGTC
CAAGCACGTCG -> AAGCACGTCGC
CAAGGGAGGTT -> AAGGGAGGTTT
CAAGTATGAAT -> AAGTATGAATT
CAATAAAAAAA -> AATAAAAAAAG
CAATAACATCC -> AATAACATCCC
CAATACAGACA -> AATACAGACAC
CAATCAATAAC -> AATCAATAACA
CAATCGGGACC -> AATCGGGACCC
CAATTAACACG -> AATTAACACGT
CAATTAACGTT -> AATTAACGTTT
CAATTAGCATA -> AATTAGCATAA
CAATTCTCCTT -> AATTCTCCTTA
CAATTTATTCG -> AATTTATTCGA
CACAAGAACGT -> ACAAGAACGTC
CACAGAAGTGT -> ACAGAAGTGTT
CACAGACCTGG -> ACAGACCTGGC
CACAGGCGTTC -> ACAGGCGTTCT
CACATAGACAG -> ACATAGACAGA
CACATGCCCTG -> ACATGCCCTGT
CACATTCCGTC -> ACATTCCGTCA
CACCAATAAAA -> ACCAATAAAAA
CACCATTTGCG -> ACCATTTGCGA
CACCCGGCCTG -> ACCCGGCCTGT
CACCCGGCTTG -> ACCCGGCTTGA
CACCCTCCCGA -> ACCCTCCCGAG
CACGAAAGACG -> ACGAAAGACGC
CACGAGCATTA -> ACGAGCATTAT
CACGCTCCGCT -> ACGCTCCGCTC
CACGGATGGAC -> ACGGATGGACG
CACGTAAAGGG -> ACGTAAAGGGA
CACGTCGCGGG -> ACGTCGCGGGC
CACGTTAAGCC -> ACGTTAAGCCC
CACGTTGCTCA -> ACGTTGCTCAC
CACTACCCGTA -> ACTACCCGTAT
CACTCAGATGC -> ACTCAGATGCC
CACTCAGCTAT -> ACTCAGCTATC
CACTCAGTCCG -> ACTCAGTCCGG
CACTGATGTAT -> ACTGATGTATC
CACTGCAAACG -> ACTGCAAACGG
CACTGGCCGTC -> ACTGGCCGTCG
CACTGGTCCAG -> ACTGGTCCAGA
CACTTCGGATA -> ACTTCGGATAG
CACTTTTACTA -> ACTTTTACTAC
CAGAAGTGTTC -> AGAAGTGTTCC
CAGAATCTATC -> AGAATCTATCC
CAGACAAAGCC -> AGACAAAGCCC
CAGACACTGCA -> AGACACTGCAA
CAGACCGGCAC -> AGACCGGCACT
CAGACCTGGCG -> AGACCTGGCGC
CAGAGCCTATC -> AGAGCCTATCG
CAGAGCTGCAA -> AGAGCTGCAAC
CAGAGTTTTAT -> AGAGTTTTATG
CAGATGCCAAT -> AGATGCCAATT
CAGCGGAATTA -> AGCGGAATTAA
CAGCTACCCAC -> AGCTACCCACA
CAGCTATCAAA -> AGCTATCAAAC
CAGCTCCACAT -> AGCTCCACATA
CAGCTTATCGA -> AGCTTATCGAG
CAGGAAATAAT -> AGGAAATAATG
CAGGAATTAAG -> AGGAATTAAGA
CAGGACCTCTT -> AGGACCTCTTG
CAGGCGTTCTG -> AGGCGTTCTGA
CAGGCTAATAA -> AGGCTAATAAT
CAGGGAAACTC -> AGGGAAACTCC
CAGGGAATTTA -> AGGGAATTTAG
CAGGGCAGCTA -> AGGGCAGCTAC
CAGGGGATTGT -> AGGGGATTGTC
CAGGTGAGCAC -> AGGTGAGCACC
CAGGTGGTCCT -> AGGTGGTCCTC
CAGTAGAGTAC -> AGTAGAGTACT
CAGTCACTTTT -> AGTCACTTTTA
CAGTCCGGAGA -> AGTCCGGAGAC
CAGTGAGACTG -> AGTGAGACTGA
CAGTGTAGAGC -> AGTGTAGAGCG
CAGTTAGTCCA -> AGTTAGTCCAG
CAGTTCTTCTT -> AGTTCTTCTTA
CATAACTCCAA -> ATAACTCCAAA
CATACCAGAGC -> ATACCAGAGCC
CATACCAGTAG -> ATACCAGTAGA
CATACTGTATG -> ATACTGTATGC
CATAGAAATGA -> ATAGAAATGAG
CATAGACAGAA -> ATAGACAGAAT
CATAGGGGAAA -> ATAGGGGAAAC
CATCAATTAAC -> ATCAATTAACA
CATCCACAGAA -> ATCCACAGAAG
CATCCCAGACA -> ATCCCAGACAA
CATCGTGGGCC -> ATCGTGGGCCC
CATCTCTCATC -> ATCTCTCATCA
CATCTTCTCCT -> ATCTTCTCCTT
CATGCCCTGTA -> ATGCCCTGTAA
CATGCGCTCCC -> ATGCGCTCCCT
CATGGAGAGAA -> ATGGAGAGAAG
CATGGGTAGAC -> ATGGGTAGACT
CATGTATTGGG -> ATGTATTGGGA
CATGTGGAGCA -> ATGTGGAGCAA
CATTAACTAGG -> ATTAACTAGGG
CATTATACGAA -> ATTATACGAAA
CATTCACATTC -> ATTCACATTCC
CATTCCACTGA -> ATTCCACTGAT
CATTCCGTCAT -> ATTCCGTCATT
CATTTGCGACA -> ATTTGCGACAA
CATTTGGCGGG -> ATTTGGCGGGT
CCAAAACATCT -> CAAAACATCTT
CCAAATAGACT -> CAAATAGACTT
CCAACGTAGAC -> CAACGTAGACC
CCAAGATACTG -> CAAGATACTGT
CCAATAAAAAA -> CAATAAAAAAA
CCAATTAACGT -> CAATTAACGTT
CCACAGAAGTG -> CACAGAAGTGT
CCACAGGCGTT -> CACAGGCGTTC
CCACATAGACA -> CACATAGACAG
CCACATGCCCT -> CACATGCCCTG
CCACCATTTGC -> CACCATTTGCG
CCACCCTCCCG -> CACCCTCCCGA
CCACGAAAGAC -> CACGAAAGACG
CCACGCTCCGC -> CACGCTCCGCT
CCACGTAAAGG -> CACGTAAAGGG
CCACTCAGATG -> CACTCAGATGC
CCACTGATGTA -> CACTGATGTAT
CCACTGGCCGT -> CACTGGCCGTC
CCAGACAAAGC -> CAGACAAAGCC
CCAGACCGGCA -> CAGACCGGCAC
CCAGAGCCTAT -> CAGAGCCTATC
CCAGCTCCACA -> CAGCTCCACAT
CCAGGTGAGCA -> CAGGTGAGCAC
CCAGTAGAGTA -> CAGTAGAGTAC
CCAGTGTAGAG -> CAGTGTAGAGC
CCATCCACAGA -> CATCCACAGAA
CCATTTGCGAC -> CATTTGCGACA
CCCACAGGCGT -> CCACAGGCGTT
CCCACCATTTG -> CCACCATTTGC
CCCACCCTCCC -> CCACCCTCCCG
CCCACGCTCCG -> CCACGCTCCGC
CCCAGACAAAG -> CCAGACAAAGC
CCCAGGTGAGC -> CCAGGTGAGCA
CCCAGTGTAGA -> CCAGTGTAGAG
CCCCACCCTCC -> CCCACCCTCCC
CCCCCGTCGGC -> CCCCGTCGGCG
CCCCCTCGAAA -> CCCCTCGAAAG
CCCCGTAGATT -> CCCGTAGATTT
CCCCGTCGGCG -> CCCGTCGGCGG
CCCCGTGTAGT -> CCCGTGTAGTC
CCCCTCGAAAG -> CCCTCGAAAGT
CCCGAAATTGA -> CCGAAATTGAC
CCCGAGCCACT -> CCGAGCCACTC
CCCGAGGCCCG -> CCGAGGCCCGT
CCCGGAGTCAG -> CCGGAGTCAGG
CCCGGCCTGTT -> CCGGCCTGTTC
CCCGGCTTGAA -> CCGGCTTGAAC
CCCGTAGATTT -> CCGTAGATTTA
CCCGTAGGCCG -> CCGTAGGCCGT
CCCGTAGGGGA -> CCGTAGGGGAA
CCCGTATAGCA -> CCGTATAGCAT
CCCGTCGGCGG -> CCGTCGGCGGA
CCCGTGTAGTC -> CCGTGTAGTCC
CCCTCCCGAGG -> CCTCCCGAGGC
CCCTCGAAAGT -> CCTCGAAAGTG
CCCTCGACTGC -> CCTCGACTGCC
CCCTCGAGGGA -> CCTCGAGGGAG
CCCTGGATAGC -> CCTGGATAGCA
CCCTGGGCCCC -> CCTGGGCCCCG
CCCTGTAAACA -> CCTGTAAACAG
CCCTTACACCC -> CCTTACACCCG
CCCTTTGTAAG -> CCTTTGTAAGC
CCGAAATTGAC -> CGAAATTGACT
CCGAACTGATC -> CGAACTGATCA
CCGAAGCTAGC -> CGAAGCTAGCC
CCGACAGGGAA -> CGACAGGGAAA
CCGACGGTGTA -> CGACGGTGTAG
CCGAGAGCTTC -> CGAGAGCTTCT
CCGAGCCACTC -> CGAGCCACTCA
CCGAGCCGACA -> CGAGCCGACAG
CCGAGGCCCGT -> CGAGGCCCGTA
CCGCCTGGCCG -> CGCCTGGCCGT
CCGCGGCCGGC -> CGCGGCCGGCG
CCGCTCAATTC -> CGCTCAATTCT
CCGCTGCAGAG -> CGCTGCAGAGT
CCGGAGACGGC -> CGGAGACGGCG
CCGGAGTCAGG -> CGGAGTCAGGA
CCGGCACTCAG -> CGGCACTCAGC
CCGGCCTGTTC -> CGGCCTGTTCA
CCGGCGCAAAG -> CGGCGCAAAGA
CCGGCTTGAAC -> CGGCTTGAACA
CCGGGCGCGAA -> CGGGCGCGAAC
CCGGGGGACGT -> CGGGGGACGTG
CCGGGGGCTTA -> CGGGGGCTTAC
CCGTACGGGTA -> CGTACGGGTAG
CCGTAGAGTTG -> CGTAGAGTTGG
CCGTAGATTTA -> CGTAGATTTAC
CCGTAGCAGCT -> CGTAGCAGCTT
CCGTAGCGAGG -> CGTAGCGAGGT
CCGTAGGCCGT -> CGTAGGCCGTA
CCGTAGGGGAA -> CGTAGGGGAAA
CCGTATAGCAT -> CGTATAGCATA
CCGTCACCCGG -> CGTCACCCGGC
CCGTCATTTGG -> CGTCATTTGGC
CCGTCGGCGGA -> CGTCGGCGGAG
CCGTCGTAGTC -> CGTCGTAGTCT
CCGTGTAGTCC -> CGTGTAGTCCT
CCGTGTTGATC -> CGTGTTGATCT
CCTAGCAAGAC -> CTAGCAAGACT
CCTATCGAAAC -> CTATCGAAACG
CCTATCTAGCT -> CTATCTAGCTT
CCTCACTCAGT -> CTCACTCAGTC
CCTCCCGAGGC -> CTCCCGAGGCC
CCTCCGTAGAG -> CTCCGTAGAGT
CCTCGAAAGTG -> CTCGAAAGTGC
CCTCGACTGCC -> CTCGACTGCCG
CCTCGAGGGAG -> CTCGAGGGAGT
CCTCGTTGGTC -> CTCGTTGGTCG
CCTCTATCCCG -> CTCTATCCCGG
CCTCTATGGAT -> CTCTATGGATC
CCTCTTGTATG -> CTCTTGTATGG
CCTGATGGCCT -> CTGATGGCCTC
CCTGGATAGCA -> CTGGATAGCAT
CCTGGCCGTAC -> CTGGCCGTACG
CCTGGCGCATG -> CTGGCGCATGG
CCTGGGCCCCG -> CTGGGCCCCGT
CCTGGGTTGGA -> CTGGGTTGGAC
CCTGGTAATGG -> CTGGTAATGGA
CCTGTAAACAG -> CTGTAAACAGT
CCTGTCTAACC -> CTGTCTAACCT
CCTGTTCAGGT -> CTGTTCAGGTG
CCTTACAATTT -> CTTACAATTTA
CCTTACACCCG -> CTTACACCCGG
CCTTCTGCCGA -> CTTCTGCCGAG
CCTTGAGATGA -> CTTGAGATGAA
CCTTTCTTCAT -> CTTTCTTCATC
CCTTTGATTGT -> CTTTGATTGTT
CCTTTGTAAGC -> CTTTGTAAGCC
CGAAACAGAGC -> GAAACAGAGCT
CGAAACGGACT -> GAAACGGACTG
CGAAAGACGCA -> GAAAGACGCAT
CGAAAGTCCTG -> GAAAGTCCTGG
CGAAAGTGCGA -> GAAAGTGCGAC
CGAAATTGACT -> GAAATTGACTG
CGAACCTTGAG -> GAACCTTGAGA
CGAACTGATCA -> GAACTGATCAC
CGAAGCTAGCC -> GAAGCTAGCCT
CGAATACGACC -> GAATACGACCG
CGACAATCGGG -> GACAATCGGGA
CGACAGGGAAA -> GACAGGGAAAC
CGACCGACGGT -> GACCGACGGTG
CGACCGGGGGA -> GACCGGGGGAC
CGACGGTGTAG -> GACGGTGTAGA
CGACTACAGGG -> GACTACAGGGC
CGACTGCCGCG -> GACTGCCGCGG
CGAGAGCTTCT -> GAGAGCTTCTT
CGAGCAGGAAT -> GAGCAGGAATT
CGAGCATTATA -> GAGCATTATAC
CGAGCCACATG -> GAGCCACATGC
CGAGCCACTCA -> GAGCCACTCAG
CGAGCCGACAG -> GAGCCGACAGG
CGAGGCCCGTA -> GAGGCCCGTAG
CGAGGGACCCA -> GAGGGACCCAC
CGAGGGAGTAC -> GAGGGAGTACA
CGAGGTCGTCC -> GAGGTCGTCCC
CGATCTGTCAA -> GATCTGTCAAC
CGATGTATTAT -> GATGTATTATG
CGCAAAGATTG -> GCAAAGATTGA
CGCAAAGATTT -> GCAAAGATTTA
CGCAATACAGA -> GCAATACAGAC
CGCACAAGAAC -> GCACAAGAACG
CGCATGGGTAG -> GCATGGGTAGA
CGCATTAACTA -> GCATTAACTAG
CGCCCAGTGTA -> GCCCAGTGTAG
CGCCTGGCCGT -> GCCTGGCCGTA
CGCCTTCTGCC -> GCCTTCTGCCG
CGCGAACCTTG -> GCGAACCTTGA
CGCGAGCCACA -> GCGAGCCACAT
CGCGGACGAAT -> GCGGACGAATA
CGCGGAGTGTC -> GCGGAGTGTCC
CGCGGCCGGCG -> GCGGCCGGCGC
CGCGGGCTAAG -> GCGGGCTAAGT
CGCTCAATTCT -> GCTCAATTCTC
CGCTCCCTTTG -> GCTCCCTTTGT
CGCTCCGCTCA -> GCTCCGCTCAA
CGCTGCAGAGT -> GCTGCAGAGTT
CGCTTAAAAAC -> GCTTAAAAACT
CGCTTACACTA -> GCTTACACTAC
CGGAATGCAAT -> GGAATGCAATC
CGGAATTAAGT -> GGAATTAAGTG
CGGACGAATAC -> GGACGAATACG
CGGACTGGTCT -> GGACTGGTCTG
CGGAGACGGCG -> GGAGACGGCGG
CGGAGGCCCTC -> GGAGGCCCTCG
CGGAGTCAGGA -> GGAGTCAGGAC
CGGAGTGTCCG -> GGAGTGTCCGC
CGGATAGACGA -> GGATAGACGAG
CGGATGGACGC -> GGATGGACGCT
CGGATGGGATG -> GGATGGGATGT
CGGATTTATGG -> GGATTTATGGT
CGGCACTCAGC -> GGCACTCAGCT
CGGCCGGCGCA -> GGCCGGCGCAA
CGGCCTGTTCA -> GGCCTGTTCAG
CGGCGCAAAGA -> GGCGCAAAGAT
CGGCGGAGGCC -> GGCGGAGGCCC
CGGCGGATTTA -> GGCGGATTTAT
CGGCGGCGTCA -> GGCGGCGTCAA
CGGCGTCAAGA -> GGCGTCAAGAC
CGGCTGGGCCG -> GGCTGGGCCGC
CGGCTTGAACA -> GGCTTGAACAT
CGGGACCCAGG -> GGGACCCAGGT
CGGGCGCGAAC -> GGGCGCGAACC
CGGGCTAAGTC -> GGGCTAAGTCC
CGGGGGACGTG -> GGGGGACGTGG
CGGGGGCTTAC -> GGGGGCTTACC
CGGGTACTTTG -> GGGTACTTTGC
CGGGTAGACAA -> GGGTAGACAAA
CGGGTTATCGG -> GGGTTATCGGG
CGGTAATCAGC -> GGTAATCAGCG
CGGTGTAGATG -> GGTGTAGATGT
CGGTGTTACCC -> GGTGTTACCCG
CGGTTCCGAAG -> GGTTCCGAAGC
CGTAAAGGGAG -> GTAAAGGGAGA
CGTACCACGTA -> GTACCACGTAA
CGTACGCTTAC -> GTACGCTTACA
CGTACGGGTAG -> GTACGGGTAGA
CGTAGACCACT -> GTAGACCACTG
CGTAGAGTTGG -> GTAGAGTTGGT
CGTAGATTTAC -> GTAGATTTACT
CGTAGCAGCTT -> GTAGCAGCTTA
CGTAGCGAGGT -> GTAGCGAGGTC
CGTAGCTCTCT -> GTAGCTCTCTG
CGTAGGCCGTA -> GTAGGCCGTAG
CGTAGGGGAAA -> GTAGGGGAAAC
CGTAGGGTGAT -> GTAGGGTGATG
CGTAGTCTCTA -> GTAGTCTCTAT
CGTATAGCATA -> GTATAGCATAG
CGTATGGCAGG -> GTATGGCAGGG
CGTCAAGACCG -> GTCAAGACCGA
CGTCACCCGGC -> GTCACCCGGCT
CGTCATTTGGC -> GTCATTTGGCG
CGTCCCACCAT -> GTCCCACCATT
CGTCCCTCGAC -> GTCCCTCGACT
CGTCCTATCTA -> GTCCTATCTAG
CGTCCTGTCTA -> GTCCTGTCTAA
CGTCGCGAGCC -> GTCGCGAGCCA
CGTCGCGGGCT -> GTCGCGGGCTA
CGTCGGCGGAG -> GTCGGCGGAGG
CGTCGTAGTCT -> GTCGTAGTCTC
CGTGCATCGTG -> GTGCATCGTGG
CGTGGGCCCCA -> GTGGGCCCCAC
CGTGGGCGACT -> GTGGGCGACTA
CGTGTAGTCCT -> GTGTAGTCCTA
CGTGTTGATCT -> GTGTTGATCTG
CGTTAAGCCCT -> GTTAAGCCCTG
CGTTCTGAAGG -> GTTCTGAAGGC
CGTTGCTCACG -> GTTGCTCACGA
CGTTGGTCGGT -> GTTGGTCGGTT
CGTTTCGTCCT -> GTTTCGTCCTG
CGTTTGTTTGT -> GTTTGTTTGTT
CTAAATCGTCC -> TAAATCGTCCC
CTAAATTACCC -> TAAATTACCCC
CTAACCTCCGT -> TAACCTCCGTA
CTAAGTCCTCT -> TAAGTCCTCTA
CTAATAATCAT -> TAATAATCATA
CTAATGGCCTT -> TAATGGCCTTT
CTACAGGGCAG -> TACAGGGCAGC
CTACCAACGTA -> TACCAACGTAG
CTACCCACAGG -> TACCCACAGGC
CTACCCGTATA -> TACCCGTATAG
CTACGCCTTCT -> TACGCCTTCTG
CTAGCAAGACT -> TAGCAAGACTT
CTAGCCTGGTA -> TAGCCTGGTAA
CTAGCTTCTGT -> TAGCTTCTGTG
CTAGGGCGGAA -> TAGGGCGGAAT
CTATCAAACTA -> TATCAAACTAA
CTATCCACGAA -> TATCCACGAAA
CTATCCCGGAG -> TATCCCGGAGT
CTATCCGGGGG -> TATCCGGGGGC
CTATCGAAACG -> TATCGAAACGG
CTATCTAGCTT -> TATCTAGCTTC
CTATGGATCCG -> TATGGATCCGG
CTATTATTTTC -> TATTATTTTCT
CTCAATTCTCC -> TCAATTCTCCT
CTCACGAGCAT -> TCACGAGCATT
CTCACTCAGTC -> TCACTCAGTCC
CTCAGATGCCA -> TCAGATGCCAA
CTCAGCTATCA -> TCAGCTATCAA
CTCAGTCCGGA -> TCAGTCCGGAG
CTCAGTTAGTC -> TCAGTTAGTCC
CTCATCAATTA -> TCATCAATTAA
CTCCAAATAGA -> TCCAAATAGAC
CTCCACATAGA -> TCCACATAGAC
CTCCCGAGGCC -> TCCCGAGGCCC
CTCCCTTTGTA -> TCCCTTTGTAA
CTCCGCTCAAT -> TCCGCTCAATT
CTCCGTAGAGT -> TCCGTAGAGTT
CTCCGTAGCGA -> TCCGTAGCGAG
CTCCTGATGGC -> TCCTGATGGCC
CTCCTTACAAT -> TCCTTACAATT
CTCCTTTGATT -> TCCTTTGATTG
CTCGAAAGTGC -> TCGAAAGTGCG
CTCGACTGCCG -> TCGACTGCCGC
CTCGAGGGAGT -> TCGAGGGAGTA
CTCGCCCAGTG -> TCGCCCAGTGT
CTCGGATGGGA -> TCGGATGGGAT
CTCGTTGGTCG -> TCGTTGGTCGG
CTCTACCAACG -> TCTACCAACGT
CTCTATCCACG -> TCTATCCACGA
CTCTATCCCGG -> TCTATCCCGGA
CTCTATGGATC -> TCTATGGATCC
CTCTCAGTTAG -> TCTCAGTTAGT
CTCTCATCAAT -> TCTCATCAATT
CTCTCTGCCGT -> TCTCTGCCGTG
CTCTGCCAAAA -> TCTGCCAAAAC
CTCTGCCGTGT -> TCTGCCGTGTT
CTCTTGTATGG -> TCTTGTATGGT
CTGAAGGCACA -> TGAAGGCACAG
CTGACCCTGGA -> TGACCCTGGAT
CTGAGCGTGCA -> TGAGCGTGCAT
CTGAGTCGGCT -> TGAGTCGGCTG
CTGATCACTGG -> TGATCACTGGT
CTGATGGCCTC -> TGATGGCCTCT
CTGATGTATCG -> TGATGTATCGT
CTGCAAACGGT -> TGCAAACGGTA
CTGCAACAATT -> TGCAACAATTA
CTGCAGAGTTT -> TGCAGAGTTTT
CTGCCAAAACA -> TGCCAAAACAT
CTGCCGAGCCG -> TGCCGAGCCGA
CTGCCGCGGCC -> TGCCGCGGCCG
CTGCCGTGTTG -> TGCCGTGTTGA
CTGGAAGCAAG -> TGGAAGCAAGA
CTGGATAGCAT -> TGGATAGCATG
CTGGCCGTACG -> TGGCCGTACGG
CTGGCCGTCGT -> TGGCCGTCGTA
CTGGCGCATGG -> TGGCGCATGGG
CTGGCTGTGGG -> TGGCTGTGGGC
CTGGGCCCCGT -> TGGGCCCCGTA
CTGGGCCGCCT -> TGGGCCGCCTG
CTGGGTTGGAC -> TGGGTTGGACT
CTGGTAATGGA -> TGGTAATGGAC
CTGGTCCAGAC -> TGGTCCAGACC
CTGGTCTGGTT -> TGGTCTGGTTG
CTGGTTGAGTC -> TGGTTGAGTCT
CTGTAAACAGT -> TGTAAACAGTT
CTGTATGCTGT -> TGTATGCTGTG
CTGTCAACATG -> TGTCAACATGT
CTGTCTAACCT -> TGTCTAACCTC
CTGTCTTCTGG -> TGTCTTCTGGC
CTGTGCGTAGC -> TGTGCGTAGCT
CTGTGGCTGAG -> TGTGGCTGAGT
CTGTGGGCAGG -> TGTGGGCAGGG
CTGTGTCTCGC -> TGTGTCTCGCC
CTGTTCAGGTG -> TGTTCAGGTGG
CTTAAAAACTT -> TTAAAAACTTC
CTTAAGAACGT -> TTAAGAACGTT
CTTACAATTTA -> TTACAATTTAT
CTTACACCCGG -> TTACACCCGGC
CTTACACTACC -> TTACACTACCC
CTTACCTCACT -> TTACCTCACTC
CTTACGATGTA -> TTACGATGTAT
CTTACGCAAAG -> TTACGCAAAGA
CTTAGACGCAA -> TTAGACGCAAT
CTTATACACTT -> TTATACACTTC
CTTATCGAGGG -> TTATCGAGGGA
CTTCATCTCTC -> TTCATCTCTCA
CTTCGGATAGA -> TTCGGATAGAC
CTTCTCCTTTG -> TTCTCCTTTGA
CTTCTCTGCCA -> TTCTCTGCCAA
CTTCTGCCGAG -> TTCTGCCGAGC
CTTCTGGCTGT -> TTCTGGCTGTG
CTTCTGTGGCT -> TTCTGTGGCTG
CTTCTTAAGAA -> TTCTTAAGAAC
CTTCTTAGACG -> TTCTTAGACGC
CTTGAACATGG -> TTGAACATGGA
CTTGAGATGAA -> TTGAGATGAAG
CTTGTATGGTC -> TTGTATGGTCG
CTTTCAAGCAC -> TTTCAAGCACG
CTTTCTTCATC -> TTTCTTCATCT
CTTTGATTGTT -> TTTGATTGTTT
CTTTGCGAAAG -> TTTGCGAAAGT
CTTTGTAAGCC -> TTTGTAAGCCG
CTTTTACTACG -> TTTTACTACGC
CTTTTTATAAT -> TTTTTATAATA
GAAACACGTTG -> AAACACGTTGC
GAAACAGAGCT -> AAACAGAGCTG
GAAACAGGAAA -> AAACAGGAAAT
GAAACGGACTG -> AAACGGACTGG
GAAACGGCGGA -> AAACGGCGGAT
GAAACTCCGTA -> AAACTCCGTAG
GAAAGACGCAT -> AAAGACGCATT
GAAAGTAGACT -> AAAGTAGACTC
GAAAGTCCTGG -> AAAGTCCTGGG
GAAAGTGCGAC -> AAAGTGCGACC
GAAATAATGCG -> AAATAATGCGT
GAAATGAGCGG -> AAATGAGCGGT
GAAATGCTCTC -> AAATGCTCTCA
GAAATTGACTG -> AAATTGACTGG
GAACATGGAGA -> AACATGGAGAG
GAACCTTGAGA -> AACCTTGAGAT
GAACGTCCTAT -> AACGTCCTATC
GAACGTTTGTT -> AACGTTTGTTT
GAACTGATCAC -> AACTGATCACT
GAAGACAAGGG -> AAGACAAGGGA
GAAGCAAGAAA -> AAGCAAGAAAC
GAAGCTAGCCT -> AAGCTAGCCTG
GAAGGCACAGA -> AAGGCACAGAC
GAAGTACCCGA -> AAGTACCCGAA
GAAGTGTGCAT -> AAGTGTGCATA
GAAGTGTTCCG -> AAGTGTTCCGA
GAAGTTGCACG -> AAGTTGCACGG
GAATACGACCG -> AATACGACCGA
GAATCTATCCG -> AATCTATCCGG
GAATGCAATCA -> AATGCAATCAA
GAATTAAGATG -> AATTAAGATGG
GAATTAAGTGG -> AATTAAGTGGA
GAATTCTTCAG -> AATTCTTCAGC
GAATTTAGGGC -> AATTTAGGGCA
GACAAAGCCCG -> ACAAAGCCCGA
GACAAATCAAG -> ACAAATCAAGT
GACAAGGGAGG -> ACAAGGGAGGT
GACAATCGGGA -> ACAATCGGGAC
GACACTGCAAA -> ACACTGCAAAC
GACAGAATCTA -> ACAGAATCTAT
GACAGGGAAAC -> ACAGGGAAACT
GACATACCAGA -> ACATACCAGAG
GACCACTGGCC -> ACCACTGGCCG
GACCCACGCTC -> ACCCACGCTCC
GACCCAGGTGA -> ACCCAGGTGAG
GACCCCGTGTA -> ACCCCGTGTAG
GACCCTGGATA -> ACCCTGGATAG
GACCGAACTGA -> ACCGAACTGAT
GACCGACGGTG -> ACCGACGGTGT
GACCGGCACTC -> ACCGGCACTCA
GACCGGGGGAC -> ACCGGGGGACG
GACCTCTTGTA -> ACCTCTTGTAT
GACCTGGCGCA -> ACCTGGCGCAT
GACGAATACGA -> ACGAATACGAC
GACGAGCAGGA -> ACGAGCAGGAA
GACGCAATACA -> ACGCAATACAG
GACGCATTAAC -> ACGCATTAACT
GACGCTTAAAA -> ACGCTTAAAAA
GACGGCGGCGT -> ACGGCGGCGTC
GACGGTGTAGA -> ACGGTGTAGAT
GACGTGGGCGA -> ACGTGGGCGAC
GACTACAGGGC -> ACTACAGGGCA
GACTCCTGATG -> ACTCCTGATGG
GACTCGGATGG -> ACTCGGATGGG
GACTGAGCGTG -> ACTGAGCGTGC
GACTGCCGCGG -> ACTGCCGCGGC
GACTGGAAGCA -> ACTGGAAGCAA
GACTGGTCTGG -> ACTGGTCTGGT
GACTTACGCAA -> ACTTACGCAAA
GACTTATACAC -> ACTTATACACT
GACTTTCAAGC -> ACTTTCAAGCA
GAGAAATGCTC -> AGAAATGCTCT
GAGAAGTTGCA -> AGAAGTTGCAC
GAGACCCCGTG -> AGACCCCGTGT
GAGACGGCGGC -> AGACGGCGGCG
GAGACTGAGCG -> AGACTGAGCGT
GAGAGAAGTTG -> AGAGAAGTTGC
GAGAGACCCCG -> AGAGACCCCGT
GAGAGCTTCTT -> AGAGCTTCTTA
GAGATGAAGTA -> AGATGAAGTAC
GAGCAAATACT -> AGCAAATACTA
GAGCACCAATA -> AGCACCAATAA
GAGCAGGAATT -> AGCAGGAATTA
GAGCATTATAC -> AGCATTATACG
GAGCCACATGC -> AGCCACATGCC
GAGCCACTCAG -> AGCCACTCAGA
GAGCCATCCAC -> AGCCATCCACA
GAGCCGACAGG -> AGCCGACAGGG
GAGCCTATCGA -> AGCCTATCGAA
GAGCGGTGTTA -> AGCGGTGTTAC
GAGCGTATGGC -> AGCGTATGGCA
GAGCGTGCATC -> AGCGTGCATCG
GAGCTGCAACA -> AGCTGCAACAA
GAGCTTCTTAA -> AGCTTCTTAAG
GAGGCCCGTAG -> AGGCCCGTAGG
GAGGCCCTCGA -> AGGCCCTCGAG
GAGGGACCCAC -> AGGGACCCACG
GAGGGAGTACA -> AGGGAGTACAT
GAGGTCGTCCC -> AGGTCGTCCCA
GAGGTTTCGTA -> AGGTTTCGTAC
GAGTACATTCA -> AGTACATTCAC
GAGTACTGTGC -> AGTACTGTGCG
GAGTCAGGACC -> AGTCAGGACCT
GAGTCGCGGAG -> AGTCGCGGAGT
GAGTCGGCTGG -> AGTCGGCTGGG
GAGTCTCTACC -> AGTCTCTACCA
GAGTGTCCGCT -> AGTGTCCGCTG
GAGTTCCCTTA -> AGTTCCCTTAC
GAGTTGGTACA -> AGTTGGTACAG
GAGTTTTATGA -> AGTTTTATGAA
GATACTGTCTT -> ATACTGTCTTC
GATAGACGAGC -> ATAGACGAGCA
GATAGCATGTA -> ATAGCATGTAT
GATATCCAAGA -> ATATCCAAGAT
GATCACTGGTC -> ATCACTGGTCC
GATCCGGGCGC -> ATCCGGGCGCG
GATCTGACCCT -> ATCTGACCCTG
GATCTGTCAAC -> ATCTGTCAACA
GATGAAGTACC -> ATGAAGTACCC
GATGCATGCGC -> ATGCATGCGCT
GATGCCAATTA -> ATGCCAATTAA
GATGCCCCCTC -> ATGCCCCCTCG
GATGGACGCTT -> ATGGACGCTTA
GATGGAGTCGC -> ATGGAGTCGCG
GATGGCCTCTA -> ATGGCCTCTAT
GATGGGATGTA -> ATGGGATGTAG
GATGTAGTCTA -> ATGTAGTCTAA
GATGTATCGTC -> ATGTATCGTCG
GATGTATTATG -> ATGTATTATGG
GATGTGATATC -> ATGTGATATCC
GATTGATGCAT -> ATTGATGCATG
GATTGTCAGTC -> ATTGTCAGTCA
GATTGTTTCTT -> ATTGTTTCTTT
GATTTACTATT -> ATTTACTATTA
GATTTATGGTT -> ATTTATGGTTT
GATTTATTATT -> ATTTATTATTC
GCAAACGGTAA -> CAAACGGTAAT
GCAAAGATTGA -> CAAAGATTGAT
GCAAAGATTTA -> CAAAGATTTAT
GCAAATACTAA -> CAAATACTAAA
GCAACAATTAG -> CAACAATTAGC
GCAAGAAACGG -> CAAGAAACGGC
GCAAGACTTAC -> CAAGACTTACG
GCAATACAGAC -> CAATACAGACA
GCAATCAATAA -> CAATCAATAAC
GCACAAGAACG -> CACAAGAACGT
GCACAGACCTG -> CACAGACCTGG
GCACCAATAAA -> CACCAATAAAA
GCACGGATGGA -> CACGGATGGAC
GCACGTCGCGG -> CACGTCGCGGG
GCACTCAGCTA -> CACTCAGCTAT
GCAGAGTTTTA -> CAGAGTTTTAT
GCAGCTACCCA -> CAGCTACCCAC
GCAGCTTATCG -> CAGCTTATCGA
GCAGGAATTAA -> CAGGAATTAAG
GCAGGGAATTT -> CAGGGAATTTA
GCAGGGGATTG -> CAGGGGATTGT
GCATAACTCCA -> CATAACTCCAA
GCATACCAGTA -> CATACCAGTAG
GCATACTGTAT -> CATACTGTATG
GCATAGGGGAA -> CATAGGGGAAA
GCATCGTGGGC -> CATCGTGGGCC
GCATGCGCTCC -> CATGCGCTCCC
GCATGGGTAGA -> CATGGGTAGAC
GCATGTATTGG -> CATGTATTGGG
GCATTAACTAG -> CATTAACTAGG
GCATTATACGA -> CATTATACGAA
GCATTCCACTG -> CATTCCACTGA
GCCAAAACATC -> CCAAAACATCT
GCCAATTAACG -> CCAATTAACGT
GCCACATGCCC -> CCACATGCCCT
GCCACTCAGAT -> CCACTCAGATG
GCCATCCACAG -> CCATCCACAGA
GCCCAGTGTAG -> CCCAGTGTAGA
GCCCCACCCTC -> CCCCACCCTCC
GCCCCCTCGAA -> CCCCCTCGAAA
GCCCCGTAGAT -> CCCCGTAGATT
GCCCGAGCCAC -> CCCGAGCCACT
GCCCGTAGGGG -> CCCGTAGGGGA
GCCCTCGAGGG -> CCCTCGAGGGA
GCCCTGGGCCC -> CCCTGGGCCCC
GCCCTGTAAAC -> CCCTGTAAACA
GCCGACAGGGA -> CCGACAGGGAA
GCCGAGCCGAC -> CCGAGCCGACA
GCCGCCTGGCC -> CCGCCTGGCCG
GCCGCGGCCGG -> CCGCGGCCGGC
GCCGGCGCAAA -> CCGGCGCAAAG
GCCGTACGGGT -> CCGTACGGGTA
GCCGTAGCAGC -> CCGTAGCAGCT
GCCGTCACCCG -> CCGTCACCCGG
GCCGTCGTAGT -> CCGTCGTAGTC
GCCGTGTTGAT -> CCGTGTTGATC
GCCTATCGAAA -> CCTATCGAAAC
GCCTCTATGGA -> CCTCTATGGAT
GCCTGGCCGTA -> CCTGGCCGTAC
GCCTGGTAATG -> CCTGGTAATGG
GCCTGTTCAGG -> CCTGTTCAGGT
GCCTTCTGCCG -> CCTTCTGCCGA
GCCTTTCTTCA -> CCTTTCTTCAT
GCGAAAGTCCT -> CGAAAGTCCTG
GCGAACCTTGA -> CGAACCTTGAG
GCGACAATCGG -> CGACAATCGGG
GCGACCGGGGG -> CGACCGGGGGA
GCGACTACAGG -> CGACTACAGGG
GCGAGCCACAT -> CGAGCCACATG
GCGAGGTCGTC -> CGAGGTCGTCC
GCGCAAAGATT -> CGCAAAGATTG
GCGCATGGGTA -> CGCATGGGTAG
GCGCGAACCTT -> CGCGAACCTTG
GCGCTCCCTTT -> CGCTCCCTTTG
GCGGAATGCAA -> CGGAATGCAAT
GCGGAATTAAG -> CGGAATTAAGT
GCGGACGAATA -> CGGACGAATAC
GCGGAGGCCCT -> CGGAGGCCCTC
GCGGAGTGTCC -> CGGAGTGTCCG
GCGGATTTATG -> CGGATTTATGG
GCGGCCGGCGC -> CGGCCGGCGCA
GCGGCGTCAAG -> CGGCGTCAAGA
GCGGGCTAAGT -> CGGGCTAAGTC
GCGGGTTATCG -> CGGGTTATCGG
GCGGTGTTACC -> CGGTGTTACCC
GCGTAGCTCTC -> CGTAGCTCTCT
GCGTAGGGTGA -> CGTAGGGTGAT
GCGTATGGCAG -> CGTATGGCAGG
GCGTCAAGACC -> CGTCAAGACCG
GCGTGCATCGT -> CGTGCATCGTG
GCGTTCTGAAG -> CGTTCTGAAGG
GCTAAGTCCTC -> CTAAGTCCTCT
GCTAATAATCA -> CTAATAATCAT
GCTACCCACAG -> CTACCCACAGG
GCTAGCCTGGT -> CTAGCCTGGTA
GCTATCAAACT -> CTATCAAACTA
GCTCAATTCTC -> CTCAATTCTCC
GCTCACGAGCA -> CTCACGAGCAT
GCTCCACATAG -> CTCCACATAGA
GCTCCCTTTGT -> CTCCCTTTGTA
GCTCCGCTCAA -> CTCCGCTCAAT
GCTCTCAGTTA -> CTCTCAGTTAG
GCTCTCTGCCG -> CTCTCTGCCGT
GCTGAGTCGGC -> CTGAGTCGGCT
GCTGCAACAAT -> CTGCAACAATT
GCTGCAGAGTT -> CTGCAGAGTTT
GCTGGGCCGCC -> CTGGGCCGCCT
GCTGTGGGCAG -> CTGTGGGCAGG
GCTGTGTCTCG -> CTGTGTCTCGC
GCTTAAAAACT -> CTTAAAAACTT
GCTTACACTAC -> CTTACACTACC
GCTTACCTCAC -> CTTACCTCACT
GCTTATCGAGG -> CTTATCGAGGG
GCTTCTGTGGC -> CTTCTGTGGCT
GCTTCTTAAGA -> CTTCTTAAGAA
GCTTGAACATG -> CTTGAACATGG
GGAAACACGTT -> GAAACACGTTG
GGAAACAGGAA -> GAAACAGGAAA
GGAAACTCCGT -> GAAACTCCGTA
GGAAAGTAGAC -> GAAAGTAGACT
GGAAATAATGC -> GAAATAATGCG
GGAAGACAAGG -> GAAGACAAGGG
GGAAGCAAGAA -> GAAGCAAGAAA
GGAATGCAATC -> GAATGCAATCA
GGAATTAAGAT -> GAATTAAGATG
GGAATTAAGTG -> GAATTAAGTGG
GGAATTTAGGG -> GAATTTAGGGC
GGACATACCAG -> GACATACCAGA
GGACCCACGCT -> GACCCACGCTC
GGACCCAGGTG -> GACCCAGGTGA
GGACCTCTTGT -> GACCTCTTGTA
GGACGAATACG -> GACGAATACGA
GGACGCTTAAA -> GACGCTTAAAA
GGACGTGGGCG -> GACGTGGGCGA
GGACTGGTCTG -> GACTGGTCTGG
GGACTTATACA -> GACTTATACAC
GGAGAAATGCT -> GAGAAATGCTC
GGAGACGGCGG -> GAGACGGCGGC
GGAGAGAAGTT -> GAGAGAAGTTG
GGAGCAAATAC -> GAGCAAATACT
GGAGCCATCCA -> GAGCCATCCAC
GGAGGCCCTCG -> GAGGCCCTCGA
GGAGGTTTCGT -> GAGGTTTCGTA
GGAGTACATTC -> GAGTACATTCA
GGAGTCAGGAC -> GAGTCAGGACC
GGAGTCGCGGA -> GAGTCGCGGAG
GGAGTGTCCGC -> GAGTGTCCGCT
GGAGTTCCCTT -> GAGTTCCCTTA
GGATAGACGAG -> GATAGACGAGC
GGATAGCATGT -> GATAGCATGTA
GGATCCGGGCG -> GATCCGGGCGC
GGATGGACGCT -> GATGGACGCTT
GGATGGGATGT -> GATGGGATGTA
GGATGTAGTCT -> GATGTAGTCTA
GGATTGTCAGT -> GATTGTCAGTC
GGATTTATGGT -> GATTTATGGTT
GGCACAGACCT -> GCACAGACCTG
GGCACTCAGCT -> GCACTCAGCTA
GGCAGCTACCC -> GCAGCTACCCA
GGCAGGGAATT -> GCAGGGAATTT
GGCAGGGGATT -> GCAGGGGATTG
GGCATACCAGT -> GCATACCAGTA
GGCCCCACCCT -> GCCCCACCCTC
GGCCCCGTAGA -> GCCCCGTAGAT
GGCCCGTAGGG -> GCCCGTAGGGG
GGCCCTCGAGG -> GCCCTCGAGGG
GGCCGCCTGGC -> GCCGCCTGGCC
GGCCGGCGCAA -> GCCGGCGCAAA
GGCCGTACGGG -> GCCGTACGGGT
GGCCGTAGCAG -> GCCGTAGCAGC
GGCCGTCGTAG -> GCCGTCGTAGT
GGCCTCTATGG -> GCCTCTATGGA
GGCCTGTTCAG -> GCCTGTTCAGG
GGCCTTTCTTC -> GCCTTTCTTCA
GGCGACTACAG -> GCGACTACAGG
GGCGCAAAGAT -> GCGCAAAGATT
GGCGCATGGGT -> GCGCATGGGTA
GGCGCGAACCT -> GCGCGAACCTT
GGCGGAATGCA -> GCGGAATGCAA
GGCGGAGGCCC -> GCGGAGGCCCT
GGCGGATTTAT -> GCGGATTTATG
GGCGGCGTCAA -> GCGGCGTCAAG
GGCGGGTTATC -> GCGGGTTATCG
GGCGTCAAGAC -> GCGTCAAGACC
GGCGTTCTGAA -> GCGTTCTGAAG
GGCTAAGTCCT -> GCTAAGTCCTC
GGCTAATAATC -> GCTAATAATCA
GGCTGAGTCGG -> GCTGAGTCGGC
GGCTGGGCCGC -> GCTGGGCCGCC
GGCTGTGGGCA -> GCTGTGGGCAG
GGCTTACCTCA -> GCTTACCTCAC
GGCTTGAACAT -> GCTTGAACATG
GGGAAACACGT -> GGAAACACGTT
GGGAAACAGGA -> GGAAACAGGAA
GGGAAACTCCG -> GGAAACTCCGT
GGGAAGACAAG -> GGAAGACAAGG
GGGAATTTAGG -> GGAATTTAGGG
GGGACCCACGC -> GGACCCACGCT
GGGACCCAGGT -> GGACCCAGGTG
GGGACGTGGGC -> GGACGTGGGCG
GGGAGAAATGC -> GGAGAAATGCT
GGGAGGTTTCG -> GGAGGTTTCGT
GGGAGTACATT -> GGAGTACATTC
GGGATGTAGTC -> GGATGTAGTCT
GGGATTGTCAG -> GGATTGTCAGT
GGGCAGCTACC -> GGCAGCTACCC
GGGCAGGGGAT -> GGCAGGGGATT
GGGCATACCAG -> GGCATACCAGT
GGGCCCCACCC -> GGCCCCACCCT
GGGCCCCGTAG -> GGCCCCGTAGA
GGGCCGCCTGG -> GGCCGCCTGGC
GGGCGACTACA -> GGCGACTACAG
GGGCGCGAACC -> GGCGCGAACCT
GGGCGGAATGC -> GGCGGAATGCA
GGGCTAAGTCC -> GGCTAAGTCCT
GGGCTTACCTC -> GGCTTACCTCA
GGGGAAACACG -> GGGAAACACGT
GGGGAAACAGG -> GGGAAACAGGA
GGGGACGTGGG -> GGGACGTGGGC
GGGGATTGTCA -> GGGATTGTCAG
GGGGCTTACCT -> GGGCTTACCTC
GGGGGACGTGG -> GGGGACGTGGG
GGGGGCTTACC -> GGGGCTTACCT
GGGGTTGGAGC -> GGGTTGGAGCC
GGGTACTTTGC -> GGTACTTTGCG
GGGTAGACAAA -> GGTAGACAAAT
GGGTAGACTCG -> GGTAGACTCGG
GGGTGATGCCC -> GGTGATGCCCC
GGGTTATCGGG -> GGTTATCGGGT
GGGTTGGACTT -> GGTTGGACTTA
GGGTTGGAGCC -> GGTTGGAGCCA
GGTAATCAGCG -> GTAATCAGCGG
GGTAATGGACA -> GTAATGGACAT
GGTACAGGCTA -> GTACAGGCTAA
GGTACTTTGCG -> GTACTTTGCGA
GGTAGACAAAT -> GTAGACAAATC
GGTAGACTCGG -> GTAGACTCGGA
GGTCCAGACCG -> GTCCAGACCGG
GGTCCTCGTTG -> GTCCTCGTTGG
GGTCGCGGACG -> GTCGCGGACGA
GGTCGGTTCCG -> GTCGGTTCCGA
GGTCGTCCCAC -> GTCGTCCCACC
GGTCTGGTTGA -> GTCTGGTTGAG
GGTGAGCACCA -> GTGAGCACCAA
GGTGATGCCCC -> GTGATGCCCCC
GGTGGTCCTCG -> GTGGTCCTCGT
GGTGTAGATGT -> GTGTAGATGTG
GGTGTTACCCG -> GTGTTACCCGT
GGTTATCGGGT -> GTTATCGGGTA
GGTTCCGAAGC -> GTTCCGAAGCT
GGTTGAGTCTC -> GTTGAGTCTCT
GGTTGGACTTA -> GTTGGACTTAT
GGTTGGAGCCA -> GTTGGAGCCAT
GGTTTCGCACA -> GTTTCGCACAA
GGTTTCGTACG -> GTTTCGTACGC
GTAAACAGTTC -> TAAACAGTTCT
GTAAAGGGAGA -> TAAAGGGAGAA
GTAAGCCGTCA -> TAAGCCGTCAC
GTAATCAGCGG -> TAATCAGCGGA
GTAATGGACAT -> TAATGGACATA
GTACAGGCTAA -> TACAGGCTAAT
GTACATTCACA -> TACATTCACAT
GTACCACGTAA -> TACCACGTAAA
GTACCCGAAAT -> TACCCGAAATT
GTACGCTTACA -> TACGCTTACAC
GTACGGGTAGA -> TACGGGTAGAC
GTACTGTGCGT -> TACTGTGCGTA
GTACTTTGCGA -> TACTTTGCGAA
GTAGACAAATC -> TAGACAAATCA
GTAGACCACTG -> TAGACCACTGG
GTAGACTCCTG -> TAGACTCCTGA
GTAGACTCGGA -> TAGACTCGGAT
GTAGAGCGTAT -> TAGAGCGTATG
GTAGAGTACTG -> TAGAGTACTGT
GTAGAGTTGGT -> TAGAGTTGGTA
GTAGATGTGAT -> TAGATGTGATA
GTAGATTTACT -> TAGATTTACTA
GTAGCAGCTTA -> TAGCAGCTTAT
GTAGCGAGGTC -> TAGCGAGGTCG
GTAGCTCTCTG -> TAGCTCTCTGC
GTAGGAGTTCC -> TAGGAGTTCCC
GTAGGCCGTAG -> TAGGCCGTAGC
GTAGGGGAAAC -> TAGGGGAAACA
GTAGGGTGATG -> TAGGGTGATGC
GTAGTCCTAGC -> TAGTCCTAGCA
GTAGTCTAAAT -> TAGTCTAAATC
GTAGTCTCTAT -> TAGTCTCTATC
GTATAGCATAG -> TATAGCATAGG
GTATCGTCGCG -> TATCGTCGCGA
GTATGAATTCT -> TATGAATTCTT
GTATGCTGTGT -> TATGCTGTGTC
GTATGGCAGGG -> TATGGCAGGGA
GTATGGTCGCG -> TATGGTCGCGG
GTATTATGGGG -> TATTATGGGGT
GTATTGGGAAG -> TATTGGGAAGA
GTCAACATGTG -> TCAACATGTGG
GTCAAGACCGA -> TCAAGACCGAA
GTCACCCGGCT -> TCACCCGGCTT
GTCACTTTTAC -> TCACTTTTACT
GTCAGGACCTC -> TCAGGACCTCT
GTCAGTCACTT -> TCAGTCACTTT
GTCATTTGGCG -> TCATTTGGCGG
GTCCAGACCGG -> TCCAGACCGGC
GTCCAGCTCCA -> TCCAGCTCCAC
GTCCCACCATT -> TCCCACCATTT
GTCCCTCGACT -> TCCCTCGACTG
GTCCGCTGCAG -> TCCGCTGCAGA
GTCCGGAGACG -> TCCGGAGACGG
GTCCTAGCAAG -> TCCTAGCAAGA
GTCCTATCTAG -> TCCTATCTAGC
GTCCTCGTTGG -> TCCTCGTTGGT
GTCCTCTATCC -> TCCTCTATCCC
GTCCTGGGTTG -> TCCTGGGTTGG
GTCCTGTCTAA -> TCCTGTCTAAC
GTCGCGAGCCA -> TCGCGAGCCAC
GTCGCGGACGA -> TCGCGGACGAA
GTCGCGGAGTG -> TCGCGGAGTGT
GTCGCGGGCTA -> TCGCGGGCTAA
GTCGGCGGAGG -> TCGGCGGAGGC
GTCGGCTGGGC -> TCGGCTGGGCC
GTCGGTTCCGA -> TCGGTTCCGAA
GTCGTAGTCTC -> TCGTAGTCTCT
GTCGTCCCACC -> TCGTCCCACCA
GTCTAAATCGT -> TCTAAATCGTC
GTCTAACCTCC -> TCTAACCTCCG
GTCTCGCCCAG -> TCTCGCCCAGT
GTCTCTACCAA -> TCTCTACCAAC
GTCTCTATCCA -> TCTCTATCCAC
GTCTGGTTGAG -> TCTGGTTGAGT
GTCTTCTGGCT -> TCTTCTGGCTG
GTGAGACTGAG -> TGAGACTGAGC
GTGAGAGACCC -> TGAGAGACCCC
GTGAGCACCAA -> TGAGCACCAAT
GTGATATCCAA -> TGATATCCAAG
GTGATGCCCCC -> TGATGCCCCCT
GTGCATACTGT -> TGCATACTGTA
GTGCATCGTGG -> TGCATCGTGGG
GTGCGACCGGG -> TGCGACCGGGG
GTGCGTAGCTC -> TGCGTAGCTCT
GTGGAAAGTAG -> TGGAAAGTAGA
GTGGAGCAAAT -> TGGAGCAAATA
GTGGCTGAGTC -> TGGCTGAGTCG
GTGGGCAGGGG -> TGGGCAGGGGA
GTGGGCCCCAC -> TGGGCCCCACC
GTGGGCGACTA -> TGGGCGACTAC
GTGGTCCTCGT -> TGGTCCTCGTT
GTGTAGAGCGT -> TGTAGAGCGTA
GTGTAGATGTG -> TGTAGATGTGA
GTGTAGTCCTA -> TGTAGTCCTAG
GTGTCCGCTGC -> TGTCCGCTGCA
GTGTCTCGCCC -> TGTCTCGCCCA
GTGTGCATACT -> TGTGCATACTG
GTGTTACCCGT -> TGTTACCCGTA
GTGTTCCGAGA -> TGTTCCGAGAG
GTGTTGATCTG -> TGTTGATCTGA
GTTAAGCCCTG -> TTAAGCCCTGG
GTTACCCGTAG -> TTACCCGTAGG
GTTAGTCCAGC -> TTAGTCCAGCT
GTTATCGGGTA -> TTATCGGGTAC
GTTCAGGTGGT -> TTCAGGTGGTC
GTTCAGTGAGA -> TTCAGTGAGAC
GTTCCCTTACA -> TTCCCTTACAC
GTTCCGAAGCT -> TTCCGAAGCTA
GTTCCGAGAGC -> TTCCGAGAGCT
GTTCTGAAGGC -> TTCTGAAGGCA
GTTCTTCTTAG -> TTCTTCTTAGA
GTTGAGTCTCT -> TTGAGTCTCTA
GTTGATCTGAC -> TTGATCTGACC
GTTGCACGGAT -> TTGCACGGATG
GTTGCTCACGA -> TTGCTCACGAG
GTTGGACTTAT -> TTGGACTTATA
GTTGGAGCCAT -> TTGGAGCCATC
GTTGGTACAGG -> TTGGTACAGGC
GTTGGTCGGTT -> TTGGTCGGTTC
GTTTCGCACAA -> TTTCGCACAAG
GTTTCGTACGC -> TTTCGTACGCT
GTTTCGTCCTG -> TTTCGTCCTGT
GTTTCTTTTTA -> TTTCTTTTTAT
GTTTGTTCAGT -> TTTGTTCAGTG
GTTTGTTTGTT -> TTTGTTTGTTC
GTTTTATGAAG -> TTTTATGAAGT
TAAAAAAAGCA -> AAAAAAAGCAT
TAAAAACTTCT -> AAAAACTTCTC
TAAACAGTTCT -> AAACAGTTCTT
TAAAGGGAGAA -> AAAGGGAGAAA
TAAATCGTCCC -> AAATCGTCCCT
TAAATTACCCC -> AAATTACCCCC
TAACACGTTAA -> AACACGTTAAG
TAACATCCCAG -> AACATCCCAGA
TAACCTCCGTA -> AACCTCCGTAG
TAACGTTTCGT -> AACGTTTCGTC
TAACTAGGGCG -> AACTAGGGCGG
TAACTCCAAAT -> AACTCCAAATA
TAAGAACGTTT -> AAGAACGTTTG
TAAGATGGAGT -> AAGATGGAGTC
TAAGCCCTGGG -> AAGCCCTGGGC
TAAGCCGTCAC -> AAGCCGTCACC
TAAGTCCTCTA -> AAGTCCTCTAT
TAAGTGGAAAG -> AAGTGGAAAGT
TAATAATCATA -> AATAATCATAG
TAATAATGTGA -> AATAATGTGAG
TAATCAGCGGA -> AATCAGCGGAA
TAATCATAGAA -> AATCATAGAAA
TAATGCGTAGG -> AATGCGTAGGG
TAATGGACATA -> AATGGACATAC
TAATGGCCTTT -> AATGGCCTTTC
TAATGTGAGAG -> AATGTGAGAGA
TACAATTTATT -> ACAATTTATTC
TACACCCGGCC -> ACACCCGGCCT
TACACTACCCG -> ACACTACCCGT
TACACTTCGGA -> ACACTTCGGAT
TACAGACACTG -> ACAGACACTGC
TACAGGCTAAT -> ACAGGCTAATA
TACAGGGCAGC -> ACAGGGCAGCT
TACATTCACAT -> ACATTCACATT
TACCAACGTAG -> ACCAACGTAGA
TACCACGTAAA -> ACCACGTAAAG
TACCAGAGCCT -> ACCAGAGCCTA
TACCAGTAGAG -> ACCAGTAGAGT
TACCCACAGGC -> ACCCACAGGCG
TACCCCCGTCG -> ACCCCCGTCGG
TACCCGAAATT -> ACCCGAAATTG
TACCCGTAGGC -> ACCCGTAGGCC
TACCCGTATAG -> ACCCGTATAGC
TACCTCACTCA -> ACCTCACTCAG
TACGAAACAGA -> ACGAAACAGAG
TACGACCGACG -> ACGACCGACGG
TACGATGTATT -> ACGATGTATTA
TACGCAAAGAT -> ACGCAAAGATT
TACGCCTTCTG -> ACGCCTTCTGC
TACGCTTACAC -> ACGCTTACACT
TACGGGTAGAC -> ACGGGTAGACA
TACTAAATTAC -> ACTAAATTACC
TACTACGCCTT -> ACTACGCCTTC
TACTATTATTT -> ACTATTATTTT
TACTGTATGCT -> ACTGTATGCTG
TACTGTCTTCT -> ACTGTCTTCTG
TACTGTGCGTA -> ACTGTGCGTAG
TACTTTGCGAA -> ACTTTGCGAAA
TAGAAATGAGC -> AGAAATGAGCG
TAGACAAATCA -> AGACAAATCAA
TAGACAGAATC -> AGACAGAATCT
TAGACCACTGG -> AGACCACTGGC
TAGACGAGCAG -> AGACGAGCAGG
TAGACGCAATA -> AGACGCAATAC
TAGACTCCTGA -> AGACTCCTGAT
TAGACTCGGAT -> AGACTCGGATG
TAGACTTTCAA -> AGACTTTCAAG
TAGAGCGTATG -> AGAGCGTATGG
TAGAGTACTGT -> AGAGTACTGTG
TAGAGTTGGTA -> AGAGTTGGTAC
TAGATGTGATA -> AGATGTGATAT
TAGATTTACTA -> AGATTTACTAT
TAGCAAGACTT -> AGCAAGACTTA
TAGCAGCTTAT -> AGCAGCTTATC
TAGCATAACTC -> AGCATAACTCC
TAGCATAGGGG -> AGCATAGGGGA
TAGCATGTATT -> AGCATGTATTG
TAGCCTGGTAA -> AGCCTGGTAAT
TAGCGAGGTCG -> AGCGAGGTCGT
TAGCTCTCTGC -> AGCTCTCTGCC
TAGCTTCTGTG -> AGCTTCTGTGG
TAGGAGTTCCC -> AGGAGTTCCCT
TAGGCCGTAGC -> AGGCCGTAGCA
TAGGGCATACC -> AGGGCATACCA
TAGGGCGGAAT -> AGGGCGGAATG
TAGGGGAAACA -> AGGGGAAACAC,AGGGGAAACAG
TAGGGTGATGC -> AGGGTGATGCC
TAGTCCAGCTC -> AGTCCAGCTCC
TAGTCCTAGCA -> AGTCCTAGCAA
TAGTCTAAATC -> AGTCTAAATCG
TAGTCTCTATC -> AGTCTCTATCC
TATAATAATGT -> ATAATAATGTG
TATACACTTCG -> ATACACTTCGG
TATACGAAACA -> ATACGAAACAG
TATAGCATAGG -> ATAGCATAGGG
TATCAAACTAA -> ATCAAACTAAT
TATCCAAGATA -> ATCCAAGATAC
TATCCACGAAA -> ATCCACGAAAG
TATCCCGGAGT -> ATCCCGGAGTC
TATCCGGGGGC -> ATCCGGGGGCT
TATCGAAACGG -> ATCGAAACGGA
TATCGAGGGAC -> ATCGAGGGACC
TATCGGGTACT -> ATCGGGTACTT
TATCGTCGCGA -> ATCGTCGCGAG
TATCTAGCTTC -> ATCTAGCTTCT
TATGAAGTGTG -> ATGAAGTGTGC
TATGAATTCTT -> ATGAATTCTTC
TATGCTGTGTC -> ATGCTGTGTCT
TATGGATCCGG -> ATGGATCCGGG
TATGGCAGGGA -> ATGGCAGGGAA
TATGGGGTTGG -> ATGGGGTTGGA
TATGGTCGCGG -> ATGGTCGCGGA
TATGGTTTCGC -> ATGGTTTCGCA
TATTATGGGGT -> ATTATGGGGTT
TATTATTCGTA -> ATTATTCGTAC
TATTATTTTCT -> ATTATTTTCTT
TATTCGATCTG -> ATTCGATCTGT
TATTCGTACCA -> ATTCGTACCAC
TATTGGGAAGA -> ATTGGGAAGAC
TATTTTCTTAC -> ATTTTCTTACG
TCAAACTAATG -> CAAACTAATGG
TCAACATGTGG -> CAACATGTGGA
TCAAGACCGAA -> CAAGACCGAAC
TCAAGCACGTC -> CAAGCACGTCG
TCAAGTATGAA -> CAAGTATGAAT
TCAATAACATC -> CAATAACATCC
TCAATTAACAC -> CAATTAACACG
TCAATTCTCCT -> CAATTCTCCTT
TCACATTCCGT -> CACATTCCGTC
TCACCCGGCTT -> CACCCGGCTTG
TCACGAGCATT -> CACGAGCATTA
TCACTCAGTCC -> CACTCAGTCCG
TCACTGGTCCA -> CACTGGTCCAG
TCACTTTTACT -> CACTTTTACTA
TCAGATGCCAA -> CAGATGCCAAT
TCAGCGGAATT -> CAGCGGAATTA
TCAGCTATCAA -> CAGCTATCAAA
TCAGGACCTCT -> CAGGACCTCTT
TCAGGTGGTCC -> CAGGTGGTCCT
TCAGTCACTTT -> CAGTCACTTTT
TCAGTCCGGAG -> CAGTCCGGAGA
TCAGTGAGACT -> CAGTGAGACTG
TCAGTTAGTCC -> CAGTTAGTCCA
TCATAGAAATG -> CATAGAAATGA
TCATCAATTAA -> CATCAATTAAC
TCATCTCTCAT -> CATCTCTCATC
TCATTTGGCGG -> CATTTGGCGGG
TCCAAATAGAC -> CCAAATAGACT
TCCAAGATACT -> CCAAGATACTG
TCCACAGAAGT -> CCACAGAAGTG
TCCACATAGAC -> CCACATAGACA
TCCACGAAAGA -> CCACGAAAGAC
TCCACTGATGT -> CCACTGATGTA
TCCAGACCGGC -> CCAGACCGGCA
TCCAGCTCCAC -> CCAGCTCCACA
TCCCACCATTT -> CCCACCATTTG
TCCCAGACAAA -> CCCAGACAAAG
TCCCGAGGCCC -> CCCGAGGCCCG
TCCCGGAGTCA -> CCCGGAGTCAG
TCCCTCGACTG -> CCCTCGACTGC
TCCCTTACACC -> CCCTTACACCC
TCCCTTTGTAA -> CCCTTTGTAAG
TCCGAAGCTAG -> CCGAAGCTAGC
TCCGAGAGCTT -> CCGAGAGCTTC
TCCGCTCAATT -> CCGCTCAATTC
TCCGCTGCAGA -> CCGCTGCAGAG
TCCGGAGACGG -> CCGGAGACGGC
TCCGGGCGCGA -> CCGGGCGCGAA
TCCGGGGGCTT -> CCGGGGGCTTA
TCCGTAGAGTT -> CCGTAGAGTTG
TCCGTAGCGAG -> CCGTAGCGAGG
TCCGTCATTTG -> CCGTCATTTGG
TCCTAGCAAGA -> CCTAGCAAGAC
TCCTATCTAGC -> CCTATCTAGCT
TCCTCGTTGGT -> CCTCGTTGGTC
TCCTCTATCCC -> CCTCTATCCCG
TCCTGATGGCC -> CCTGATGGCCT
TCCTGGGTTGG -> CCTGGGTTGGA
TCCTGTCTAAC -> CCTGTCTAACC
TCCTTACAATT -> CCTTACAATTT
TCCTTTGATTG -> CCTTTGATTGT
TCGAAACGGAC -> CGAAACGGACT
TCGAAAGTGCG -> CGAAAGTGCGA
TCGACTGCCGC -> CGACTGCCGCG
TCGAGGGACCC -> CGAGGGACCCA
TCGAGGGAGTA -> CGAGGGAGTAC
TCGATCTGTCA -> CGATCTGTCAA
TCGCACAAGAA -> CGCACAAGAAC
TCGCCCAGTGT -> CGCCCAGTGTA
TCGCGAGCCAC -> CGCGAGCCACA
TCGCGGACGAA -> CGCGGACGAAT
TCGCGGAGTGT -> CGCGGAGTGTC
TCGCGGGCTAA -> CGCGGGCTAAG
TCGGATAGACG -> CGGATAGACGA
TCGGATGGGAT -> CGGATGGGATG
TCGGCGGAGGC -> CGGCGGAGGCC
TCGGCTGGGCC -> CGGCTGGGCCG
TCGGGACCCAG -> CGGGACCCAGG
TCGGGTACTTT -> CGGGTACTTTG
TCGGTTCCGAA -> CGGTTCCGAAG
TCGTACCACGT -> CGTACCACGTA
TCGTACGCTTA -> CGTACGCTTAC
TCGTAGTCTCT -> CGTAGTCTCTA
TCGTCCCACCA -> CGTCCCACCAT
TCGTCCCTCGA -> CGTCCCTCGAC
TCGTCCTGTCT -> CGTCCTGTCTA
TCGTCGCGAGC -> CGTCGCGAGCC
TCGTGGGCCCC -> CGTGGGCCCCA
TCGTTGGTCGG -> CGTTGGTCGGT
TCTAAATCGTC -> CTAAATCGTCC
TCTAACCTCCG -> CTAACCTCCGT
TCTACCAACGT -> CTACCAACGTA
TCTAGCTTCTG -> CTAGCTTCTGT
TCTATCCACGA -> CTATCCACGAA
TCTATCCCGGA -> CTATCCCGGAG
TCTATCCGGGG -> CTATCCGGGGG
TCTATGGATCC -> CTATGGATCCG
TCTCAGTTAGT -> CTCAGTTAGTC
TCTCATCAATT -> CTCATCAATTA
TCTCCTTACAA -> CTCCTTACAAT
TCTCCTTTGAT -> CTCCTTTGATT
TCTCGCCCAGT -> CTCGCCCAGTG
TCTCTACCAAC -> CTCTACCAACG
TCTCTATCCAC -> CTCTATCCACG
TCTCTCATCAA -> CTCTCATCAAT
TCTCTGCCAAA -> CTCTGCCAAAA
TCTCTGCCGTG -> CTCTGCCGTGT
TCTGAAGGCAC -> CTGAAGGCACA
TCTGACCCTGG -> CTGACCCTGGA
TCTGCCAAAAC -> CTGCCAAAACA
TCTGCCGAGCC -> CTGCCGAGCCG
TCTGCCGTGTT -> CTGCCGTGTTG
TCTGGCTGTGG -> CTGGCTGTGGG
TCTGGTTGAGT -> CTGGTTGAGTC
TCTGTCAACAT -> CTGTCAACATG
TCTGTGGCTGA -> CTGTGGCTGAG
TCTTAAGAACG -> CTTAAGAACGT
TCTTACGATGT -> CTTACGATGTA
TCTTAGACGCA -> CTTAGACGCAA
TCTTCATCTCT -> CTTCATCTCTC
TCTTCTCCTTT -> CTTCTCCTTTG
TCTTCTGGCTG -> CTTCTGGCTGT
TCTTCTTAGAC -> CTTCTTAGACG
TCTTGTATGGT -> CTTGTATGGTC
TCTTTTTATAA -> CTTTTTATAAT
TGAACATGGAG -> GAACATGGAGA
TGAAGGCACAG -> GAAGGCACAGA
TGAAGTACCCG -> GAAGTACCCGA
TGAAGTGTGCA -> GAAGTGTGCAT
TGAATTCTTCA -> GAATTCTTCAG
TGACCCTGGAT -> GACCCTGGATA
TGACTGGAAGC -> GACTGGAAGCA
TGAGACTGAGC -> GAGACTGAGCG
TGAGAGACCCC -> GAGAGACCCCG
TGAGATGAAGT -> GAGATGAAGTA
TGAGCACCAAT -> GAGCACCAATA
TGAGCGGTGTT -> GAGCGGTGTTA
TGAGCGTGCAT -> GAGCGTGCATC
TGAGTCGGCTG -> GAGTCGGCTGG
TGAGTCTCTAC -> GAGTCTCTACC
TGATATCCAAG -> GATATCCAAGA
TGATCACTGGT -> GATCACTGGTC
TGATCTGACCC -> GATCTGACCCT
TGATGCATGCG -> GATGCATGCGC
TGATGCCCCCT -> GATGCCCCCTC
TGATGGCCTCT -> GATGGCCTCTA
TGATGTATCGT -> GATGTATCGTC
TGATTGTTTCT -> GATTGTTTCTT
TGCAAACGGTA -> GCAAACGGTAA
TGCAACAATTA -> GCAACAATTAG
TGCAATCAATA -> GCAATCAATAA
TGCACGGATGG -> GCACGGATGGA
TGCAGAGTTTT -> GCAGAGTTTTA
TGCATACTGTA -> GCATACTGTAT
TGCATCGTGGG -> GCATCGTGGGC
TGCATGCGCTC -> GCATGCGCTCC
TGCCAAAACAT -> GCCAAAACATC
TGCCAATTAAC -> GCCAATTAACG
TGCCCCCTCGA -> GCCCCCTCGAA
TGCCCTGTAAA -> GCCCTGTAAAC
TGCCGAGCCGA -> GCCGAGCCGAC
TGCCGCGGCCG -> GCCGCGGCCGG
TGCCGTGTTGA -> GCCGTGTTGAT
TGCGAAAGTCC -> GCGAAAGTCCT
TGCGACAATCG -> GCGACAATCGG
TGCGACCGGGG -> GCGACCGGGGG
TGCGCTCCCTT -> GCGCTCCCTTT
TGCGTAGCTCT -> GCGTAGCTCTC
TGCGTAGGGTG -> GCGTAGGGTGA
TGCTCACGAGC -> GCTCACGAGCA
TGCTCTCAGTT -> GCTCTCAGTTA
TGCTGTGTCTC -> GCTGTGTCTCG
TGGAAAGTAGA -> GGAAAGTAGAC
TGGAAGCAAGA -> GGAAGCAAGAA
TGGACATACCA -> GGACATACCAG
TGGACGCTTAA -> GGACGCTTAAA
TGGACTTATAC -> GGACTTATACA
TGGAGAGAAGT -> GGAGAGAAGTT
TGGAGCAAATA -> GGAGCAAATAC
TGGAGCCATCC -> GGAGCCATCCA
TGGAGTCGCGG -> GGAGTCGCGGA
TGGATAGCATG -> GGATAGCATGT
TGGATCCGGGC -> GGATCCGGGCG
TGGCAGGGAAT -> GGCAGGGAATT
TGGCCGTACGG -> GGCCGTACGGG
TGGCCGTCGTA -> GGCCGTCGTAG
TGGCCTCTATG -> GGCCTCTATGG
TGGCCTTTCTT -> GGCCTTTCTTC
TGGCGCATGGG -> GGCGCATGGGT
TGGCGGGTTAT -> GGCGGGTTATC
TGGCTGAGTCG -> GGCTGAGTCGG
TGGCTGTGGGC -> GGCTGTGGGCA
TGGGAAGACAA -> GGGAAGACAAG
TGGGATGTAGT -> GGGATGTAGTC
TGGGCAGGGGA -> GGGCAGGGGAT
TGGGCCCCACC -> GGGCCCCACCC
TGGGCCCCGTA -> GGGCCCCGTAG
TGGGCCGCCTG -> GGGCCGCCTGG
TGGGCGACTAC -> GGGCGACTACA
TGGGGTTGGAG -> GGGGTTGGAGC
TGGGTAGACTC -> GGGTAGACTCG
TGGGTTGGACT -> GGGTTGGACTT
TGGTAATGGAC -> GGTAATGGACA
TGGTACAGGCT -> GGTACAGGCTA
TGGTCCAGACC -> GGTCCAGACCG
TGGTCCTCGTT -> GGTCCTCGTTG
TGGTCGCGGAC -> GGTCGCGGACG
TGGTCGGTTCC -> GGTCGGTTCCG
TGGTCTGGTTG -> GGTCTGGTTGA
TGGTTGAGTCT -> GGTTGAGTCTC
TGGTTTCGCAC -> GGTTTCGCACA
TGTAAACAGTT -> GTAAACAGTTC
TGTAAGCCGTC -> GTAAGCCGTCA
TGTAGAGCGTA -> GTAGAGCGTAT
TGTAGATGTGA -> GTAGATGTGAT
TGTAGTCCTAG -> GTAGTCCTAGC
TGTAGTCTAAA -> GTAGTCTAAAT
TGTATCGTCGC -> GTATCGTCGCG
TGTATGCTGTG -> GTATGCTGTGT
TGTATGGTCGC -> GTATGGTCGCG
TGTATTATGGG -> GTATTATGGGG
TGTATTGGGAA -> GTATTGGGAAG
TGTCAACATGT -> GTCAACATGTG
TGTCAGTCACT -> GTCAGTCACTT
TGTCCGCTGCA -> GTCCGCTGCAG
TGTCTAACCTC -> GTCTAACCTCC
TGTCTCGCCCA -> GTCTCGCCCAG
TGTCTTCTGGC -> GTCTTCTGGCT
TGTGAGAGACC -> GTGAGAGACCC
TGTGATATCCA -> GTGATATCCAA
TGTGCATACTG -> GTGCATACTGT
TGTGCGTAGCT -> GTGCGTAGCTC
TGTGGAGCAAA -> GTGGAGCAAAT
TGTGGCTGAGT -> GTGGCTGAGTC
TGTGGGCAGGG -> GTGGGCAGGGG
TGTGTCTCGCC -> GTGTCTCGCCC
TGTTACCCGTA -> GTTACCCGTAG
TGTTCAGGTGG -> GTTCAGGTGGT
TGTTCAGTGAG -> GTTCAGTGAGA
TGTTCCGAGAG -> GTTCCGAGAGC
TGTTGATCTGA -> GTTGATCTGAC
TGTTTCTTTTT -> GTTTCTTTTTA
TGTTTGTTCAG -> GTTTGTTCAGT
TTAAAAACTTC -> TAAAAACTTCT
TTAACACGTTA -> TAACACGTTAA
TTAACGTTTCG -> TAACGTTTCGT
TTAACTAGGGC -> TAACTAGGGCG
TTAAGAACGTT -> TAAGAACGTTT
TTAAGATGGAG -> TAAGATGGAGT
TTAAGCCCTGG -> TAAGCCCTGGG
TTAAGTGGAAA -> TAAGTGGAAAG
TTACAATTTAT -> TACAATTTATT
TTACACCCGGC -> TACACCCGGCC
TTACACTACCC -> TACACTACCCG
TTACCCCCGTC -> TACCCCCGTCG
TTACCCGTAGG -> TACCCGTAGGC
TTACCTCACTC -> TACCTCACTCA
TTACGATGTAT -> TACGATGTATT
TTACGCAAAGA -> TACGCAAAGAT
TTACTACGCCT -> TACTACGCCTT
TTACTATTATT -> TACTATTATTT
TTAGACGCAAT -> TAGACGCAATA
TTAGCATAACT -> TAGCATAACTC
TTAGGGCATAC -> TAGGGCATACC
TTAGTCCAGCT -> TAGTCCAGCTC
TTATAATAATG -> TATAATAATGT
TTATACACTTC -> TATACACTTCG
TTATACGAAAC -> TATACGAAACA
TTATCGAGGGA -> TATCGAGGGAC
TTATCGGGTAC -> TATCGGGTACT
TTATGAAGTGT -> TATGAAGTGTG
TTATGGGGTTG -> TATGGGGTTGG
TTATGGTTTCG -> TATGGTTTCGC
TTATTATTCGT -> TATTATTCGTA
TTATTCGATCT -> TATTCGATCTG
TTATTCGTACC -> TATTCGTACCA
TTATTTTCTTA -> TATTTTCTTAC
TTCAAGCACGT -> TCAAGCACGTC
TTCACATTCCG -> TCACATTCCGT
TTCAGGTGGTC -> TCAGGTGGTCC
TTCAGTGAGAC -> TCAGTGAGACT
TTCATCTCTCA -> TCATCTCTCAT
TTCCACTGATG -> TCCACTGATGT
TTCCCTTACAC -> TCCCTTACACC
TTCCGAAGCTA -> TCCGAAGCTAG
TTCCGAGAGCT -> TCCGAGAGCTT
TTCCGTCATTT -> TCCGTCATTTG
TTCGATCTGTC -> TCGATCTGTCA
TTCGCACAAGA -> TCGCACAAGAA
TTCGGATAGAC -> TCGGATAGACG
TTCGTACCACG -> TCGTACCACGT
TTCGTACGCTT -> TCGTACGCTTA
TTCGTCCTGTC -> TCGTCCTGTCT
TTCTCCTTACA -> TCTCCTTACAA
TTCTCCTTTGA -> TCTCCTTTGAT
TTCTCTGCCAA -> TCTCTGCCAAA
TTCTGAAGGCA -> TCTGAAGGCAC
TTCTGCCGAGC -> TCTGCCGAGCC
TTCTGGCTGTG -> TCTGGCTGTGG
TTCTGTGGCTG -> TCTGTGGCTGA
TTCTTAAGAAC -> TCTTAAGAACG
TTCTTACGATG -> TCTTACGATGT
TTCTTAGACGC -> TCTTAGACGCA
TTCTTCATCTC -> TCTTCATCTCT
TTCTTCTTAGA -> TCTTCTTAGAC
TTCTTTTTATA -> TCTTTTTATAA
TTGAACATGGA -> TGAACATGGAG
TTGACTGGAAG -> TGACTGGAAGC
TTGAGATGAAG -> TGAGATGAAGT
TTGAGTCTCTA -> TGAGTCTCTAC
TTGATCTGACC -> TGATCTGACCC
TTGATGCATGC -> TGATGCATGCG
TTGATTGTTTC -> TGATTGTTTCT
TTGCACGGATG -> TGCACGGATGG
TTGCGAAAGTC -> TGCGAAAGTCC
TTGCGACAATC -> TGCGACAATCG
TTGCTCACGAG -> TGCTCACGAGC
TTGGACTTATA -> TGGACTTATAC
TTGGAGCCATC -> TGGAGCCATCC
TTGGCGGGTTA -> TGGCGGGTTAT
TTGGGAAGACA -> TGGGAAGACAA
TTGGTACAGGC -> TGGTACAGGCT
TTGGTCGGTTC -> TGGTCGGTTCC
TTGTAAGCCGT -> TGTAAGCCGTC
TTGTATGGTCG -> TGTATGGTCGC
TTGTCAGTCAC -> TGTCAGTCACT
TTGTTCAGTGA -> TGTTCAGTGAG
TTGTTTCTTTT -> TGTTTCTTTTT
TTGTTTGTTCA -> TGTTTGTTCAG
TTTACTACGCC -> TTACTACGCCT
TTTACTATTAT -> TTACTATTATT
TTTAGGGCATA -> TTAGGGCATAC
TTTATAATAAT -> TTATAATAATG
TTTATGAAGTG -> TTATGAAGTGT
TTTATGGTTTC -> TTATGGTTTCG
TTTATTATTCG -> TTATTATTCGT
TTTATTCGATC -> TTATTCGATCT
TTTCAAGCACG -> TTCAAGCACGT
TTTCGCACAAG -> TTCGCACAAGA
TTTCGTACGCT -> TTCGTACGCTT
TTTCGTCCTGT -> TTCGTCCTGTC
TTTCTTACGAT -> TTCTTACGATG
TTTCTTCATCT -> TTCTTCATCTC
TTTCTTTTTAT -> TTCTTTTTATA
TTTGATTGTTT -> TTGATTGTTTC
TTTGCGAAAGT -> TTGCGAAAGTC
TTTGCGACAAT -> TTGCGACAATC
TTTGGCGGGTT -> TTGGCGGGTTA
TTTGTAAGCCG -> TTGTAAGCCGT
TTTGTTCAGTG -> TTGTTCAGTGA
TTTGTTTGTTC -> TTGTTTGTTCA
TTTTACTACGC -> TTTACTACGCC
TTTTATAATAA -> TTTATAATAAT
TTTTATGAAGT -> TTTATGAAGTG
TTTTCTTACGA -> TTTCTTACGAT
TTTTTATAATA -> TTTTATAATAA