AAAAACCGAGCACGGCAGA -> AAAACCGAGCACGGCAGAT
AAAACAGATACTCAGGCGG -> AAACAGATACTCAGGCGGG
AAAACCGAGCACGGCAGAT -> AAACCGAGCACGGCAGATC
AAAACTCTACCGCTACCAA -> AAACTCTACCGCTACCAAA
AAAAGATTTTTTATACCCT -> AAAGATTTTTTATACCCTT
AAAAGGGGCACTGCATGCT -> AAAGGGGCACTGCATGCTG
AAACAGATACTCAGGCGGG -> AACAGATACTCAGGCGGGG
AAACCATCATAGGAACACA -> AACCATCATAGGAACACAC
AAACCGAGCACGGCAGATC -> AACCGAGCACGGCAGATCA
AAACCGGCTGATGTGGCTC -> AACCGGCTGATGTGGCTCG
AAACGCGACTCTACCAAAT -> AACGCGACTCTACCAAATT
AAACGTAGGTCCATAGTGG -> AACGTAGGTCCATAGTGGG
AAACTCTACCGCTACCAAA -> AACTCTACCGCTACCAAAT
AAAGAGTTCCTTTAGCACC -> AAGAGTTCCTTTAGCACCT
AAAGATTTTTTATACCCTT -> AAGATTTTTTATACCCTTA
AAAGCTCCAATCATGAGTA -> AAGCTCCAATCATGAGTAG
AAAGGGGCACTGCATGCTG -> AAGGGGCACTGCATGCTGG
AAAGGGTGAGAACGTTACT -> AAGGGTGAGAACGTTACTA
AAAGTAGCCCGGCTGATGG -> AAGTAGCCCGGCTGATGGA
AAAGTCAGCTGTTTTGTTC -> AAGTCAGCTGTTTTGTTCC
AAATAGGAATATCACCGCA -> AATAGGAATATCACCGCAT
AAATCATCTATAGTTCTCC -> AATCATCTATAGTTCTCCC
AAATCCTATTATAGGTACT -> AATCCTATTATAGGTACTG
AAATGCGTTGTTTTTCAGA -> AATGCGTTGTTTTTCAGAG
AAATGCTTTGAAATCCTAT -> AATGCTTTGAAATCCTATT
AAATGGCAGCAGAGGGTGA -> AATGGCAGCAGAGGGTGAG
AAATTTCCGACTGTTGCGA -> AATTTCCGACTGTTGCGAC
AACAACCCTGGCCGGTCGG -> ACAACCCTGGCCGGTCGGT
AACAACCTTTGAAAGCTCC -> ACAACCTTTGAAAGCTCCA
AACAAGAGACAGCACTGTT -> ACAAGAGACAGCACTGTTG
AACACACTCCAGGAATCAT -> ACACACTCCAGGAATCATC
AACACCAACTGCTTCTTTG -> ACACCAACTGCTTCTTTGC
AACAGATACTCAGGCGGGG -> ACAGATACTCAGGCGGGGA
AACATAGGGTGAACCTCAA -> ACATAGGGTGAACCTCAAC
AACCACTGACAGAAGCTCA -> ACCACTGACAGAAGCTCAA
AACCAGTGCACAGGGGCAT -> ACCAGTGCACAGGGGCATC
AACCATCATAGGAACACAC -> ACCATCATAGGAACACACT
AACCCTGGCCGGTCGGTTT -> ACCCTGGCCGGTCGGTTTC
AACCGAGCACGGCAGATCA -> ACCGAGCACGGCAGATCAT
AACCGCTGCCCACCTGCTG -> ACCGCTGCCCACCTGCTGT
AACCGGCTGATGTGGCTCG -> ACCGGCTGATGTGGCTCGG
AACCTCAACTCGTGCCATT -> ACCTCAACTCGTGCCATTG
AACCTTCACGAGGCAAAGT -> ACCTTCACGAGGCAAAGTA
AACCTTTGAAAGCTCCAAT -> ACCTTTGAAAGCTCCAATC
AACGACCCTACGATAGGGA -> ACGACCCTACGATAGGGAT
AACGATTTGGTATTGAAAG -> ACGATTTGGTATTGAAAGG
AACGCGACTCTACCAAATT -> ACGCGACTCTACCAAATTT
AACGCTAGGCGATACTAAT -> ACGCTAGGCGATACTAATA
AACGGAGCGATCTCAAACG -> ACGGAGCGATCTCAAACGC
AACGGCAGAGCCTATAAGG -> ACGGCAGAGCCTATAAGGG
AACGGCTCATATCGCAAAC -> ACGGCTCATATCGCAAACC
AACGTAGGTCCATAGTGGG -> ACGTAGGTCCATAGTGGGA
AACGTCGCAATGCCCCTCA -> ACGTCGCAATGCCCCTCAT
AACGTTACTACTTGTAGGC -> ACGTTACTACTTGTAGGCT
AACTCATAAGGCCGACAGT -> ACTCATAAGGCCGACAGTG
AACTCCAATAACGGAGCGA -> ACTCCAATAACGGAGCGAT
AACTCGTGCCATTGATTGG -> ACTCGTGCCATTGATTGGT
AACTCTACCGCTACCAAAT -> ACTCTACCGCTACCAAATG
AACTGCAGAACAACCTTTG -> ACTGCAGAACAACCTTTGA
AACTGCTTCTTTGCCATGT -> ACTGCTTCTTTGCCATGTG
AACTGGGCCTATTTAAGGT -> ACTGGGCCTATTTAAGGTG
AACTTCATGGTCGCCTGAG -> ACTTCATGGTCGCCTGAGT
AACTTGCTTACATGTCAAT -> ACTTGCTTACATGTCAATT
AAGAACGGCAGAGCCTATA -> AGAACGGCAGAGCCTATAA
AAGAATGAGTGTAACAAGA -> AGAATGAGTGTAACAAGAG
AAGACAATCGGTTTGCTAA -> AGACAATCGGTTTGCTAAT
AAGAGACAGCACTGTTGAG -> AGAGACAGCACTGTTGAGG
AAGAGTTCCTTTAGCACCT -> AGAGTTCCTTTAGCACCTG
AAGATTTTTTATACCCTTA -> AGATTTTTTATACCCTTAT
AAGCCCCCCTGTAAGCTGA -> AGCCCCCCTGTAAGCTGAT
AAGCGACTCGTTGGATATC -> AGCGACTCGTTGGATATCT
AAGCGGCCGATTTGCAGGG -> AGCGGCCGATTTGCAGGGC
AAGCGTTGGATATCTGGGT -> AGCGTTGGATATCTGGGTT
AAGCTCAACCTTCACGAGG -> AGCTCAACCTTCACGAGGC
AAGCTCCAATCATGAGTAG -> AGCTCCAATCATGAGTAGC
AAGCTGATAACTTGCTTAC -> AGCTGATAACTTGCTTACA
AAGGCCGACAGTGCTTGCT -> AGGCCGACAGTGCTTGCTT
AAGGCCTAGGCGTCACTGA -> AGGCCTAGGCGTCACTGAC
AAGGGACGCTTTGGAGAAT -> AGGGACGCTTTGGAGAATG
AAGGGGCACTGCATGCTGG -> AGGGGCACTGCATGCTGGC
AAGGGTGAGAACGTTACTA -> AGGGTGAGAACGTTACTAC
AAGGTGCTCTCGAGACGGG -> AGGTGCTCTCGAGACGGGG
AAGTAGCCCGGCTGATGGA -> AGTAGCCCGGCTGATGGAG
AAGTATCACCTTAGCCGGG -> AGTATCACCTTAGCCGGGT
AAGTATCGTCGCACGTCTA -> AGTATCGTCGCACGTCTAC
AAGTCAGCTGTTTTGTTCC -> AGTCAGCTGTTTTGTTCCA
AAGTGTGTCGACCTCTAGT -> AGTGTGTCGACCTCTAGTG
AAGTTGGGTTTGATTCCAA -> AGTTGGGTTTGATTCCAAA
AATAACGGAGCGATCTCAA -> ATAACGGAGCGATCTCAAA
AATAAGAACGGCAGAGCCT -> ATAAGAACGGCAGAGCCTA
AATAATTGGATTGAAGACA -> ATAATTGGATTGAAGACAA
AATAGACGGACCGGCAGTC -> ATAGACGGACCGGCAGTCG
AATAGGAATATCACCGCAT -> ATAGGAATATCACCGCATG
AATATAGTGTAATTTACCA -> ATATAGTGTAATTTACCAC
AATATCACCGCATGATCCA -> ATATCACCGCATGATCCAT
AATCATCACCCCGAACGAC -> ATCATCACCCCGAACGACC
AATCATCTATAGTTCTCCC -> ATCATCTATAGTTCTCCCA
AATCATGAGTAGCCATAGA -> ATCATGAGTAGCCATAGAC
AATCCATGAAACCGGCTGA -> ATCCATGAAACCGGCTGAT
AATCCTATTATAGGTACTG -> ATCCTATTATAGGTACTGA
AATCGCCGAGATATCCGAG -> ATCGCCGAGATATCCGAGT
AATCGGATTTGAGACAGCC -> ATCGGATTTGAGACAGCCG
AATCGGTTTGCTAATTCAG -> ATCGGTTTGCTAATTCAGT
AATGAAGCGACTCGTTGGA -> ATGAAGCGACTCGTTGGAT
AATGAAGCGGCCGATTTGC -> ATGAAGCGGCCGATTTGCA
AATGAGTGTAACAAGAGAC -> ATGAGTGTAACAAGAGACA
AATGATTATGTAGCGGGTC -> ATGATTATGTAGCGGGTCT
AATGCCCAGACGGCATCCC -> ATGCCCAGACGGCATCCCT
AATGCCCCTCATATCTACG -> ATGCCCCTCATATCTACGG
AATGCGTTGTTTTTCAGAG -> ATGCGTTGTTTTTCAGAGA
AATGCTTTGAAATCCTATT -> ATGCTTTGAAATCCTATTA
AATGGCAGCAGAGGGTGAG -> ATGGCAGCAGAGGGTGAGG
AATGGCGAACCAGTGCACA -> ATGGCGAACCAGTGCACAG
AATGTTTAGGAAAGTCAGC -> ATGTTTAGGAAAGTCAGCT
AATTCAGTTCATTCACGAG -> ATTCAGTTCATTCACGAGC
AATTGGATTGAAGACAATC -> ATTGGATTGAAGACAATCG
AATTTACCACGATCCATTG -> ATTTACCACGATCCATTGT
AATTTACCCGGACACCAGG -> ATTTACCCGGACACCAGGG
AATTTCCGACTGTTGCGAC -> ATTTCCGACTGTTGCGACG
AATTTGACTAACTGCAGAA -> ATTTGACTAACTGCAGAAC
AATTTGATTAATTTACCCG -> ATTTGATTAATTTACCCGG
AATTTGCAACGATTTGGTA -> ATTTGCAACGATTTGGTAT
ACAAAAGGGGCACTGCATG -> CAAAAGGGGCACTGCATGC
ACAACCCTGGCCGGTCGGT -> CAACCCTGGCCGGTCGGTT
ACAACCTTTGAAAGCTCCA -> CAACCTTTGAAAGCTCCAA
ACAACGCTAGGCGATACTA -> CAACGCTAGGCGATACTAA
ACAAGAGACAGCACTGTTG -> CAAGAGACAGCACTGTTGA
ACAATCGGTTTGCTAATTC -> CAATCGGTTTGCTAATTCA
ACAATGAAGCGGCCGATTT -> CAATGAAGCGGCCGATTTG
ACAATTTGATTAATTTACC -> CAATTTGATTAATTTACCC
ACACACTCCAGGAATCATC -> CACACTCCAGGAATCATCA
ACACCAACTGCTTCTTTGC -> CACCAACTGCTTCTTTGCC
ACACCAGGGTAATGATTAT -> CACCAGGGTAATGATTATG
ACACCCATAACACCAACTG -> CACCCATAACACCAACTGC
ACACCGTAGGGCCGTCAGG -> CACCGTAGGGCCGTCAGGG
ACACTAGATGGCTACCAAA -> CACTAGATGGCTACCAAAG
ACACTCCAGGAATCATCAC -> CACTCCAGGAATCATCACC
ACAGAAAACTCTACCGCTA -> CAGAAAACTCTACCGCTAC
ACAGAAGCTCAACCTTCAC -> CAGAAGCTCAACCTTCACG
ACAGAATGGCGAACCAGTG -> CAGAATGGCGAACCAGTGC
ACAGACACTAGATGGCTAC -> CAGACACTAGATGGCTACC
ACAGAGCACAATGAAGCGG -> CAGAGCACAATGAAGCGGC
ACAGATACTCAGGCGGGGA -> CAGATACTCAGGCGGGGAT
ACAGCACTGTTGAGGCGGC -> CAGCACTGTTGAGGCGGCG
ACAGCCGTAAGGCCTAGGC -> CAGCCGTAAGGCCTAGGCG
ACAGGGGCATCGGAGTCTT -> CAGGGGCATCGGAGTCTTA
ACAGTCTGGCGCTGAGGGT -> CAGTCTGGCGCTGAGGGTG
ACAGTCTTGATGGAATTTG -> CAGTCTTGATGGAATTTGA
ACAGTGCTTGCTTTGCTTA -> CAGTGCTTGCTTTGCTTAT
ACATAGGGTGAACCTCAAC -> CATAGGGTGAACCTCAACT
ACATCTCTAGGACGACAAA -> CATCTCTAGGACGACAAAA
ACATGTCAATTTGCAACGA -> CATGTCAATTTGCAACGAT
ACCAAAGAGTTCCTTTAGC -> CCAAAGAGTTCCTTTAGCA
ACCAAATGCGTTGTTTTTC -> CCAAATGCGTTGTTTTTCA
ACCAAATTTCCGACTGTTG -> CCAAATTTCCGACTGTTGC
ACCAACTGCTTCTTTGCCA -> CCAACTGCTTCTTTGCCAT
ACCAATCGGATTTGAGACA -> CCAATCGGATTTGAGACAG
ACCACGATCCATTGTACAT -> CCACGATCCATTGTACATC
ACCACTGACAGAAGCTCAA -> CCACTGACAGAAGCTCAAC
ACCAGGCGAGCTCGTTGGA -> CCAGGCGAGCTCGTTGGAT
ACCAGGGTAATGATTATGT -> CCAGGGTAATGATTATGTA
ACCAGTGCACAGGGGCATC -> CCAGTGCACAGGGGCATCG
ACCATCATAGGAACACACT -> CCATCATAGGAACACACTC
ACCCATAACACCAACTGCT -> CCCATAACACCAACTGCTT
ACCCATTATTTCCAGCGAG -> CCCATTATTTCCAGCGAGG
ACCCATTTGACTATGCATG -> CCCATTTGACTATGCATGA
ACCCCGAACGACCCTACGA -> CCCCGAACGACCCTACGAT
ACCCGGACACCAGGGTAAT -> CCCGGACACCAGGGTAATG
ACCCTACGATAGGGATAAG -> CCCTACGATAGGGATAAGA
ACCCTGGCCGGTCGGTTTC -> CCCTGGCCGGTCGGTTTCA
ACCCTTATTAATAGACGGA -> CCCTTATTAATAGACGGAC
ACCGAGCACGGCAGATCAT -> CCGAGCACGGCAGATCATT
ACCGCATGATCCATTAACT -> CCGCATGATCCATTAACTC
ACCGCTACCAAATGCGTTG -> CCGCTACCAAATGCGTTGT
ACCGCTGCCCACCTGCTGT -> CCGCTGCCCACCTGCTGTG
ACCGCTTGTTATCCGTGGG -> CCGCTTGTTATCCGTGGGT
ACCGGCAGTCGCCCTGAAC -> CCGGCAGTCGCCCTGAACG
ACCGGCTGATGTGGCTCGG -> CCGGCTGATGTGGCTCGGG
ACCGGTAGCCCACCGTGTC -> CCGGTAGCCCACCGTGTCG
ACCGTAGGGCCGTCAGGGC -> CCGTAGGGCCGTCAGGGCC
ACCGTGTCGCTTCCCTCAG -> CCGTGTCGCTTCCCTCAGT
ACCTCAACTCGTGCCATTG -> CCTCAACTCGTGCCATTGA
ACCTCTAGTGGTCTGTCTG -> CCTCTAGTGGTCTGTCTGC
ACCTGCTGTGGTTCTCAGC -> CCTGCTGTGGTTCTCAGCC
ACCTGTTGACACCGTAGGG -> CCTGTTGACACCGTAGGGC
ACCTTAGCCGGGTACACCC -> CCTTAGCCGGGTACACCCA
ACCTTCACGAGGCAAAGTA -> CCTTCACGAGGCAAAGTAG
ACCTTTGAAAGCTCCAATC -> CCTTTGAAAGCTCCAATCA
ACGACAAAAGGGGCACTGC -> CGACAAAAGGGGCACTGCA
ACGACCCTACGATAGGGAT -> CGACCCTACGATAGGGATA
ACGAGCAGCCGTCAGCGAG -> CGAGCAGCCGTCAGCGAGG
ACGAGGCAAAGTAGCCCGG -> CGAGGCAAAGTAGCCCGGC
ACGATAGGGATAAGAATGA -> CGATAGGGATAAGAATGAG
ACGATCCATTGTACATCTC -> CGATCCATTGTACATCTCT
ACGATTTGGTATTGAAAGG -> CGATTTGGTATTGAAAGGG
ACGCACAACGCTAGGCGAT -> CGCACAACGCTAGGCGATA
ACGCACGCGTAACCACTGA -> CGCACGCGTAACCACTGAC
ACGCCGGCTGAGGAGCTTA -> CGCCGGCTGAGGAGCTTAG
ACGCGACTCTACCAAATTT -> CGCGACTCTACCAAATTTC
ACGCGTAACCACTGACAGA -> CGCGTAACCACTGACAGAA
ACGCGTCCCAATGCCCAGA -> CGCGTCCCAATGCCCAGAC
ACGCTAGGCGATACTAATA -> CGCTAGGCGATACTAATAT
ACGCTCCTTGCTTATAGCA -> CGCTCCTTGCTTATAGCAC
ACGCTTTGGAGAATGTTTA -> CGCTTTGGAGAATGTTTAG
ACGGACCGGCAGTCGCCCT -> CGGACCGGCAGTCGCCCTG
ACGGAGCGATCTCAAACGC -> CGGAGCGATCTCAAACGCG
ACGGCAGAGCCTATAAGGG -> CGGCAGAGCCTATAAGGGA
ACGGCAGATCATTTAATAA -> CGGCAGATCATTTAATAAT
ACGGCATCCCTTGTTGTTC -> CGGCATCCCTTGTTGTTCT
ACGGCCATCCAAGTGTGTC -> CGGCCATCCAAGTGTGTCG
ACGGCGCTAAATGGCAGCA -> CGGCGCTAAATGGCAGCAG
ACGGCTCATATCGCAAACC -> CGGCTCATATCGCAAACCA
ACGGCTCCTCAGCACCCAT -> CGGCTCCTCAGCACCCATT
ACGGGCTCCAACTCATAAG -> CGGGCTCCAACTCATAAGG
ACGGGGTAGAAAAGATTTT -> CGGGGTAGAAAAGATTTTT
ACGTAGGTCCATAGTGGGA -> CGTAGGTCCATAGTGGGAC
ACGTCGCAATGCCCCTCAT -> CGTCGCAATGCCCCTCATA
ACGTCTACAGTCTGGCGCT -> CGTCTACAGTCTGGCGCTG
ACGTTACTACTTGTAGGCT -> CGTTACTACTTGTAGGCTC
ACGTTAGGGTAGCTGGAGA -> CGTTAGGGTAGCTGGAGAG
ACTAACTGCAGAACAACCT -> CTAACTGCAGAACAACCTT
ACTAATATAGTGTAATTTA -> CTAATATAGTGTAATTTAC
ACTACTTGTAGGCTCGGCC -> CTACTTGTAGGCTCGGCCA
ACTAGATGGCTACCAAAGA -> CTAGATGGCTACCAAAGAG
ACTATGCATGAACGGCTCA -> CTATGCATGAACGGCTCAT
ACTCAGGCGGGGATTCAGT -> CTCAGGCGGGGATTCAGTT
ACTCATAAGGCCGACAGTG -> CTCATAAGGCCGACAGTGC
ACTCATTACGCGTCCCAAT -> CTCATTACGCGTCCCAATG
ACTCCAATAACGGAGCGAT -> CTCCAATAACGGAGCGATC
ACTCCAGGAATCATCACCC -> CTCCAGGAATCATCACCCC
ACTCGTGCCATTGATTGGT -> CTCGTGCCATTGATTGGTA
ACTCGTTGGATATCTGGGT -> CTCGTTGGATATCTGGGTT
ACTCTACCAAATTTCCGAC -> CTCTACCAAATTTCCGACT
ACTCTACCGCTACCAAATG -> CTCTACCGCTACCAAATGC
ACTGAACTGGGCCTATTTA -> CTGAACTGGGCCTATTTAA
ACTGACAGAAGCTCAACCT -> CTGACAGAAGCTCAACCTT
ACTGACGTTAGGGTAGCTG -> CTGACGTTAGGGTAGCTGG
ACTGATACAGTCTTGATGG -> CTGATACAGTCTTGATGGA
ACTGCAGAACAACCTTTGA -> CTGCAGAACAACCTTTGAA
ACTGCATGCTGGCCCAGTA -> CTGCATGCTGGCCCAGTAG
ACTGCCGGTGCAGCGCCGC -> CTGCCGGTGCAGCGCCGCC
ACTGCTTCTTTGCCATGTG -> CTGCTTCTTTGCCATGTGA
ACTGGGCCTATTTAAGGTG -> CTGGGCCTATTTAAGGTGC
ACTGTTGAGGCGGCGGTCC -> CTGTTGAGGCGGCGGTCCT
ACTGTTGCGACGGCGCTAA -> CTGTTGCGACGGCGCTAAA
ACTTCATGGTCGCCTGAGT -> CTTCATGGTCGCCTGAGTA
ACTTCCAACAACCCTGGCC -> CTTCCAACAACCCTGGCCG
ACTTGCTTACATGTCAATT -> CTTGCTTACATGTCAATTT
ACTTGTAGGCTCGGCCAAG -> CTTGTAGGCTCGGCCAAGT
AGAAAACTCTACCGCTACC -> GAAAACTCTACCGCTACCA
AGAAAAGATTTTTTATACC -> GAAAAGATTTTTTATACCC
AGAACAACCTTTGAAAGCT -> GAACAACCTTTGAAAGCTC
AGAACGGCAGAGCCTATAA -> GAACGGCAGAGCCTATAAG
AGAACGTTACTACTTGTAG -> GAACGTTACTACTTGTAGG
AGAAGCCCCCCTGTAAGCT -> GAAGCCCCCCTGTAAGCTG
AGAAGCTCAACCTTCACGA -> GAAGCTCAACCTTCACGAG
AGAATGAAGCGACTCGTTG -> GAATGAAGCGACTCGTTGG
AGAATGAGTGTAACAAGAG -> GAATGAGTGTAACAAGAGA
AGAATGGCGAACCAGTGCA -> GAATGGCGAACCAGTGCAC
AGAATGTTTAGGAAAGTCA -> GAATGTTTAGGAAAGTCAG
AGACAATCGGTTTGCTAAT -> GACAATCGGTTTGCTAATT
AGACACTAGATGGCTACCA -> GACACTAGATGGCTACCAA
AGACAGAATGGCGAACCAG -> GACAGAATGGCGAACCAGT
AGACAGACACTAGATGGCT -> GACAGACACTAGATGGCTA
AGACAGCACTGTTGAGGCG -> GACAGCACTGTTGAGGCGG
AGACAGCCGTAAGGCCTAG -> GACAGCCGTAAGGCCTAGG
AGACCAGGCGAGCTCGTTG -> GACCAGGCGAGCTCGTTGG
AGACGGACCGGCAGTCGCC -> GACGGACCGGCAGTCGCCC
AGACGGCATCCCTTGTTGT -> GACGGCATCCCTTGTTGTT
AGACGGGGTAGAAAAGATT -> GACGGGGTAGAAAAGATTT
AGAGAAGCCCCCCTGTAAG -> GAGAAGCCCCCCTGTAAGC
AGAGACAGCACTGTTGAGG -> GAGACAGCACTGTTGAGGC
AGAGCACAATGAAGCGGCC -> GAGCACAATGAAGCGGCCG
AGAGCCTATAAGGGACGCT -> GAGCCTATAAGGGACGCTT
AGAGGCTGAGGAAGCGTTG -> GAGGCTGAGGAAGCGTTGG
AGAGGGTGAGGATGTAACA -> GAGGGTGAGGATGTAACAT
AGAGTTCCTTTAGCACCTG -> GAGTTCCTTTAGCACCTGT
AGAGTTCGGAATAAGAACG -> GAGTTCGGAATAAGAACGG
AGATACTCAGGCGGGGATT -> GATACTCAGGCGGGGATTC
AGATATCCGAGTAGCTCGG -> GATATCCGAGTAGCTCGGA
AGATCATTTAATAATTGGA -> GATCATTTAATAATTGGAT
AGATGGCTACCAAAGAGTT -> GATGGCTACCAAAGAGTTC
AGATTTTTGCCCCGCGTTG -> GATTTTTGCCCCGCGTTGG
AGATTTTTTATACCCTTAT -> GATTTTTTATACCCTTATT
AGCACAATGAAGCGGCCGA -> GCACAATGAAGCGGCCGAT
AGCACCCATTATTTCCAGC -> GCACCCATTATTTCCAGCG
AGCACCCATTTGACTATGC -> GCACCCATTTGACTATGCA
AGCACCTGTTGACACCGTA -> GCACCTGTTGACACCGTAG
AGCACGGCAGATCATTTAA -> GCACGGCAGATCATTTAAT
AGCACTGTTGAGGCGGCGG -> GCACTGTTGAGGCGGCGGT
AGCAGAGGGTGAGGATGTA -> GCAGAGGGTGAGGATGTAA
AGCAGCCGTCAGCGAGGGT -> GCAGCCGTCAGCGAGGGTC
AGCATAATCCATGAAACCG -> GCATAATCCATGAAACCGG
AGCCATAGACAGAATGGCG -> GCCATAGACAGAATGGCGA
AGCCCACCGTGTCGCTTCC -> GCCCACCGTGTCGCTTCCC
AGCCCCCCTGTAAGCTGAT -> GCCCCCCTGTAAGCTGATA
AGCCCGGCTGATGGAGGCC -> GCCCGGCTGATGGAGGCCC
AGCCCTGGACAATTTGATT -> GCCCTGGACAATTTGATTA
AGCCGGGTACACCCATAAC -> GCCGGGTACACCCATAACA
AGCCGTAAGGCCTAGGCGT -> GCCGTAAGGCCTAGGCGTC
AGCCGTCAGCGAGGGTCCT -> GCCGTCAGCGAGGGTCCTA
AGCCTATAAGGGACGCTTT -> GCCTATAAGGGACGCTTTG
AGCGAACCGCTGCCCACCT -> GCGAACCGCTGCCCACCTG
AGCGACTCGTTGGATATCT -> GCGACTCGTTGGATATCTG
AGCGAGGGTCCTATCGCAC -> GCGAGGGTCCTATCGCACC
AGCGAGGTGTTCGCACAGA -> GCGAGGTGTTCGCACAGAG
AGCGATCTCAAACGCGACT -> GCGATCTCAAACGCGACTC
AGCGCCGCCAAAACAGATA -> GCGCCGCCAAAACAGATAC
AGCGGCCGATTTGCAGGGC -> GCGGCCGATTTGCAGGGCG
AGCGGGGCGGGTCTCGGGA -> GCGGGGCGGGTCTCGGGAT
AGCGGGTCTCGGGATGAGA -> GCGGGTCTCGGGATGAGAA
AGCGTTGGATATCTGGGTT -> GCGTTGGATATCTGGGTTC
AGCTCAACCTTCACGAGGC -> GCTCAACCTTCACGAGGCA
AGCTCCAATCATGAGTAGC -> GCTCCAATCATGAGTAGCC
AGCTCGGAGTTGTTTCGAA -> GCTCGGAGTTGTTTCGAAA
AGCTCGTTGGATATCTGGG -> GCTCGTTGGATATCTGGGT
AGCTGATAACTTGCTTACA -> GCTGATAACTTGCTTACAT
AGCTGGAGAGTTCGGAATA -> GCTGGAGAGTTCGGAATAA
AGCTGTTTTGTTCCAGGGC -> GCTGTTTTGTTCCAGGGCC
AGCTTAGGGACAGAAAACT -> GCTTAGGGACAGAAAACTC
AGGAAAGTCAGCTGTTTTG -> GGAAAGTCAGCTGTTTTGT
AGGAACACACTCCAGGAAT -> GGAACACACTCCAGGAATC
AGGAAGCGTTGGATATCTG -> GGAAGCGTTGGATATCTGG
AGGAATATCACCGCATGAT -> GGAATATCACCGCATGATC
AGGAATCATCACCCCGAAC -> GGAATCATCACCCCGAACG
AGGACGACAAAAGGGGCAC -> GGACGACAAAAGGGGCACT
AGGAGCTTAGGGACAGAAA -> GGAGCTTAGGGACAGAAAA
AGGATGTAACATAGGGTGA -> GGATGTAACATAGGGTGAA
AGGCAAAGTAGCCCGGCTG -> GGCAAAGTAGCCCGGCTGA
AGGCCCGCGGGTCTCGGGA -> GGCCCGCGGGTCTCGGGAT
AGGCCGACAGTGCTTGCTT -> GGCCGACAGTGCTTGCTTT
AGGCCTAGGCGTCACTGAC -> GGCCTAGGCGTCACTGACG
AGGCGAGCTCGTTGGATAT -> GGCGAGCTCGTTGGATATC
AGGCGATACTAATATAGTG -> GGCGATACTAATATAGTGT
AGGCGGCGGTCCTCTGGTG -> GGCGGCGGTCCTCTGGTGC
AGGCGGGGATTCAGTTTAA -> GGCGGGGATTCAGTTTAAC
AGGCGTCACTGACGTTAGG -> GGCGTCACTGACGTTAGGG
AGGCTCGGCCAAGTATCGT -> GGCTCGGCCAAGTATCGTC
AGGCTGAGGAAGCGTTGGA -> GGCTGAGGAAGCGTTGGAT
AGGCTTTTGCCTGCCGGCC -> GGCTTTTGCCTGCCGGCCC
AGGGACAGAAAACTCTACC -> GGGACAGAAAACTCTACCG
AGGGACGCTTTGGAGAATG -> GGGACGCTTTGGAGAATGT
AGGGATAAGAATGAGTGTA -> GGGATAAGAATGAGTGTAA
AGGGCCACGGCCATCCAAG -> GGGCCACGGCCATCCAAGT
AGGGCCAGTGGTACTGCCG -> GGGCCAGTGGTACTGCCGG
AGGGCCGTCAGGGCCACGG -> GGGCCGTCAGGGCCACGGC
AGGGCGATCCCCTGTTCTA -> GGGCGATCCCCTGTTCTAT
AGGGGCACTGCATGCTGGC -> GGGGCACTGCATGCTGGCC
AGGGGCATCGGAGTCTTAC -> GGGGCATCGGAGTCTTACG
AGGGTAATGATTATGTAGC -> GGGTAATGATTATGTAGCG
AGGGTAGCTGGAGAGTTCG -> GGGTAGCTGGAGAGTTCGG
AGGGTCCTATCGCACCGCT -> GGGTCCTATCGCACCGCTT
AGGGTGAACCTCAACTCGT -> GGGTGAACCTCAACTCGTG
AGGGTGAGAACGTTACTAC -> GGGTGAGAACGTTACTACT
AGGGTGAGGATGTAACATA -> GGGTGAGGATGTAACATAG
AGGTACTGAACTGGGCCTA -> GGTACTGAACTGGGCCTAT
AGGTCCATAGTGGGACGCC -> GGTCCATAGTGGGACGCCG
AGGTCGCACTGATACAGTC -> GGTCGCACTGATACAGTCT
AGGTGAGGCTTTTGCCTGC -> GGTGAGGCTTTTGCCTGCC
AGGTGCTCTCGAGACGGGG -> GGTGCTCTCGAGACGGGGT
AGGTGTTCGCACAGAGCAC -> GGTGTTCGCACAGAGCACA
AGTAGCCATAGACAGAATG -> GTAGCCATAGACAGAATGG
AGTAGCCCGGCTGATGGAG -> GTAGCCCGGCTGATGGAGG
AGTAGCTCGGAGTTGTTTC -> GTAGCTCGGAGTTGTTTCG
AGTAGGTCGCACTGATACA -> GTAGGTCGCACTGATACAG
AGTATCACCTTAGCCGGGT -> GTATCACCTTAGCCGGGTA
AGTATCCGCTCTCGTGTGG -> GTATCCGCTCTCGTGTGGT
AGTATCGTCGCACGTCTAC -> GTATCGTCGCACGTCTACA
AGTCAGCTGTTTTGTTCCA -> GTCAGCTGTTTTGTTCCAG
AGTCCAAATCATCTATAGT -> GTCCAAATCATCTATAGTT
AGTCGCCCTGAACGTCGCA -> GTCGCCCTGAACGTCGCAA
AGTCTTACGGCTCCTCAGC -> GTCTTACGGCTCCTCAGCA
AGTCTTGATGGAATTTGAC -> GTCTTGATGGAATTTGACT
AGTGCACAGGGGCATCGGA -> GTGCACAGGGGCATCGGAG
AGTGCGGGTCTCGGGATGA -> GTGCGGGTCTCGGGATGAG
AGTGCTTGCTTTGCTTATT -> GTGCTTGCTTTGCTTATTA
AGTGGGACGCCGGCTGAGG -> GTGGGACGCCGGCTGAGGA
AGTGGTACTGCCGGTGCAG -> GTGGTACTGCCGGTGCAGC
AGTGGTCTGTCTGCATGGC -> GTGGTCTGTCTGCATGGCA
AGTGTAACAAGAGACAGCA -> GTGTAACAAGAGACAGCAC
AGTGTAATTTACCACGATC -> GTGTAATTTACCACGATCC
AGTGTGTCGACCTCTAGTG -> GTGTGTCGACCTCTAGTGG
AGTTCATTCACGAGCAGCC -> GTTCATTCACGAGCAGCCG
AGTTCCTTTAGCACCTGTT -> GTTCCTTTAGCACCTGTTG
AGTTCGGAATAAGAACGGC -> GTTCGGAATAAGAACGGCA
AGTTCTCCCACGCACGCGT -> GTTCTCCCACGCACGCGTA
AGTTGGGTTTGATTCCAAA -> GTTGGGTTTGATTCCAAAC
AGTTGTTTCGAAAAACCGA -> GTTGTTTCGAAAAACCGAG
AGTTTAACTTCATGGTCGC -> GTTTAACTTCATGGTCGCC
ATAACACCAACTGCTTCTT -> TAACACCAACTGCTTCTTT
ATAACGGAGCGATCTCAAA -> TAACGGAGCGATCTCAAAC
ATAACTTGCTTACATGTCA -> TAACTTGCTTACATGTCAA
ATAAGAACGGCAGAGCCTA -> TAAGAACGGCAGAGCCTAT
ATAAGAATGAGTGTAACAA -> TAAGAATGAGTGTAACAAG
ATAAGGCCGACAGTGCTTG -> TAAGGCCGACAGTGCTTGC
ATAAGGGACGCTTTGGAGA -> TAAGGGACGCTTTGGAGAA
ATAATCCATGAAACCGGCT -> TAATCCATGAAACCGGCTG
ATAATTGGATTGAAGACAA -> TAATTGGATTGAAGACAAT
ATACAGTCTTGATGGAATT -> TACAGTCTTGATGGAATTT
ATACCCTTATTAATAGACG -> TACCCTTATTAATAGACGG
ATACTAATATAGTGTAATT -> TACTAATATAGTGTAATTT
ATACTCAGGCGGGGATTCA -> TACTCAGGCGGGGATTCAG
ATAGACAGAATGGCGAACC -> TAGACAGAATGGCGAACCA
ATAGACGGACCGGCAGTCG -> TAGACGGACCGGCAGTCGC
ATAGCACCCATTATTTCCA -> TAGCACCCATTATTTCCAG
ATAGGAACACACTCCAGGA -> TAGGAACACACTCCAGGAA
ATAGGAATATCACCGCATG -> TAGGAATATCACCGCATGA
ATAGGGATAAGAATGAGTG -> TAGGGATAAGAATGAGTGT
ATAGGGTGAACCTCAACTC -> TAGGGTGAACCTCAACTCG
ATAGGTACTGAACTGGGCC -> TAGGTACTGAACTGGGCCT
ATAGTGGGACGCCGGCTGA -> TAGTGGGACGCCGGCTGAG
ATAGTGTAATTTACCACGA -> TAGTGTAATTTACCACGAT
ATAGTTCTCCCACGCACGC -> TAGTTCTCCCACGCACGCG
ATATAGTGTAATTTACCAC -> TATAGTGTAATTTACCACG
ATATCACCGCATGATCCAT -> TATCACCGCATGATCCATT
ATATCCGAGTAGCTCGGAG -> TATCCGAGTAGCTCGGAGT
ATATCGCAAACCATCATAG -> TATCGCAAACCATCATAGG
ATATCTACGGGCTCCAACT -> TATCTACGGGCTCCAACTC
ATATCTGGGTTCTAAGTAT -> TATCTGGGTTCTAAGTATC
ATATCTGGGTTCTACGCTC -> TATCTGGGTTCTACGCTCC
ATATCTGGGTTCTGCAAAT -> TATCTGGGTTCTGCAAATA
ATATCTGGGTTCTTCGGGA -> TATCTGGGTTCTTCGGGAC
ATCACCCCGAACGACCCTA -> TCACCCCGAACGACCCTAC
ATCACCGCATGATCCATTA -> TCACCGCATGATCCATTAA
ATCACCTTAGCCGGGTACA -> TCACCTTAGCCGGGTACAC
ATCATAGGAACACACTCCA -> TCATAGGAACACACTCCAG
ATCATCACCCCGAACGACC -> TCATCACCCCGAACGACCC
ATCATCTATAGTTCTCCCA -> TCATCTATAGTTCTCCCAC
ATCATGAGTAGCCATAGAC -> TCATGAGTAGCCATAGACA
ATCATTTAATAATTGGATT -> TCATTTAATAATTGGATTG
ATCCAAGTGTGTCGACCTC -> TCCAAGTGTGTCGACCTCT
ATCCATGAAACCGGCTGAT -> TCCATGAAACCGGCTGATG
ATCCATTAACTCCAATAAC -> TCCATTAACTCCAATAACG
ATCCATTGTACATCTCTAG -> TCCATTGTACATCTCTAGG
ATCCCCTGTTCTATGGGGG -> TCCCCTGTTCTATGGGGGG
ATCCCTTGTTGTTCTAGGT -> TCCCTTGTTGTTCTAGGTG
ATCCGAGTAGCTCGGAGTT -> TCCGAGTAGCTCGGAGTTG
ATCCGCTCTCGTGTGGTTT -> TCCGCTCTCGTGTGGTTTC
ATCCGTGGGTGACCGGTAG -> TCCGTGGGTGACCGGTAGC
ATCCTATTATAGGTACTGA -> TCCTATTATAGGTACTGAA
ATCGCAAACCATCATAGGA -> TCGCAAACCATCATAGGAA
ATCGCACCGCTTGTTATCC -> TCGCACCGCTTGTTATCCG
ATCGCCGAGATATCCGAGT -> TCGCCGAGATATCCGAGTA
ATCGGAGTCTTACGGCTCC -> TCGGAGTCTTACGGCTCCT
ATCGGATTTGAGACAGCCG -> TCGGATTTGAGACAGCCGT
ATCGGTTTGCTAATTCAGT -> TCGGTTTGCTAATTCAGTT
ATCGTCGCACGTCTACAGT -> TCGTCGCACGTCTACAGTC
ATCTACCAATCGGATTTGA -> TCTACCAATCGGATTTGAG
ATCTACGGGCTCCAACTCA -> TCTACGGGCTCCAACTCAT
ATCTATAGTTCTCCCACGC -> TCTATAGTTCTCCCACGCA
ATCTCAAACGCGACTCTAC -> TCTCAAACGCGACTCTACC
ATCTCTAGGACGACAAAAG -> TCTCTAGGACGACAAAAGG
ATCTGGGTTCTAAGTATCA -> TCTGGGTTCTAAGTATCAC
ATCTGGGTTCTACGCTCCT -> TCTGGGTTCTACGCTCCTT
ATCTGGGTTCTGCAAATAG -> TCTGGGTTCTGCAAATAGG
ATCTGGGTTCTTCGGGACT -> TCTGGGTTCTTCGGGACTT
ATGAAACCGGCTGATGTGG -> TGAAACCGGCTGATGTGGC
ATGAACGGCTCATATCGCA -> TGAACGGCTCATATCGCAA
ATGAAGCGACTCGTTGGAT -> TGAAGCGACTCGTTGGATA
ATGAAGCGGCCGATTTGCA -> TGAAGCGGCCGATTTGCAG
ATGAGAATGAAGCGACTCG -> TGAGAATGAAGCGACTCGT
ATGAGACCAGGCGAGCTCG -> TGAGACCAGGCGAGCTCGT
ATGAGAGGCTGAGGAAGCG -> TGAGAGGCTGAGGAAGCGT
ATGAGATTTTTGCCCCGCG -> TGAGATTTTTGCCCCGCGT
ATGAGTAGCCATAGACAGA -> TGAGTAGCCATAGACAGAA
ATGAGTGTAACAAGAGACA -> TGAGTGTAACAAGAGACAG
ATGATCCATTAACTCCAAT -> TGATCCATTAACTCCAATA
ATGATTATGTAGCGGGTCT -> TGATTATGTAGCGGGTCTC
ATGATTTGCGTGCTGTCGT -> TGATTTGCGTGCTGTCGTC
ATGCATGAACGGCTCATAT -> TGCATGAACGGCTCATATC
ATGCCCAGACGGCATCCCT -> TGCCCAGACGGCATCCCTT
ATGCCCCTCATATCTACGG -> TGCCCCTCATATCTACGGG
ATGCGTTGTTTTTCAGAGA -> TGCGTTGTTTTTCAGAGAA
ATGCTGGCCCAGTAGGTCG -> TGCTGGCCCAGTAGGTCGC
ATGCTTTGAAATCCTATTA -> TGCTTTGAAATCCTATTAT
ATGGAATTTGACTAACTGC -> TGGAATTTGACTAACTGCA
ATGGAGGCCCGCGGGTCTC -> TGGAGGCCCGCGGGTCTCG
ATGGCACTCATTACGCGTC -> TGGCACTCATTACGCGTCC
ATGGCAGCAGAGGGTGAGG -> TGGCAGCAGAGGGTGAGGA
ATGGCGAACCAGTGCACAG -> TGGCGAACCAGTGCACAGG
ATGGCTACCAAAGAGTTCC -> TGGCTACCAAAGAGTTCCT
ATGGGGGGCAAATGCTTTG -> TGGGGGGCAAATGCTTTGA
ATGGTCGCCTGAGTATCCG -> TGGTCGCCTGAGTATCCGC
ATGTAACATAGGGTGAACC -> TGTAACATAGGGTGAACCT
ATGTAGCGGGTCTCGGGAT -> TGTAGCGGGTCTCGGGATG
ATGTCAATTTGCAACGATT -> TGTCAATTTGCAACGATTT
ATGTGATCTACCAATCGGA -> TGTGATCTACCAATCGGAT
ATGTGGCTCGGGTCTGGTC -> TGTGGCTCGGGTCTGGTCA
ATGTTTAGGAAAGTCAGCT -> TGTTTAGGAAAGTCAGCTG
ATTAACTCCAATAACGGAG -> TTAACTCCAATAACGGAGC
ATTAATAGACGGACCGGCA -> TTAATAGACGGACCGGCAG
ATTAATCGCCGAGATATCC -> TTAATCGCCGAGATATCCG
ATTAATTTACCCGGACACC -> TTAATTTACCCGGACACCA
ATTACGCGTCCCAATGCCC -> TTACGCGTCCCAATGCCCA
ATTATAGGTACTGAACTGG -> TTATAGGTACTGAACTGGG
ATTATGTAGCGGGTCTCGG -> TTATGTAGCGGGTCTCGGG
ATTATTTCCAGCGAGGTGT -> TTATTTCCAGCGAGGTGTT
ATTCACGAGCAGCCGTCAG -> TTCACGAGCAGCCGTCAGC
ATTCAGTTCATTCACGAGC -> TTCAGTTCATTCACGAGCA
ATTCAGTTTAACTTCATGG -> TTCAGTTTAACTTCATGGT
ATTCCAAACGTAGGTCCAT -> TTCCAAACGTAGGTCCATA
ATTGAAAGGGTGAGAACGT -> TTGAAAGGGTGAGAACGTT
ATTGAAGACAATCGGTTTG -> TTGAAGACAATCGGTTTGC
ATTGATTGGTAGACAGACA -> TTGATTGGTAGACAGACAC
ATTGGATTGAAGACAATCG -> TTGGATTGAAGACAATCGG
ATTGGTAGACAGACACTAG -> TTGGTAGACAGACACTAGA
ATTGTACATCTCTAGGACG -> TTGTACATCTCTAGGACGA
ATTTAAGGTGCTCTCGAGA -> TTTAAGGTGCTCTCGAGAC
ATTTAATAATTGGATTGAA -> TTTAATAATTGGATTGAAG
ATTTACCACGATCCATTGT -> TTTACCACGATCCATTGTA
ATTTACCCGGACACCAGGG -> TTTACCCGGACACCAGGGT
ATTTCCAGCGAGGTGTTCG -> TTTCCAGCGAGGTGTTCGC
ATTTCCGACTGTTGCGACG -> TTTCCGACTGTTGCGACGG
ATTTGACTAACTGCAGAAC -> TTTGACTAACTGCAGAACA
ATTTGACTATGCATGAACG -> TTTGACTATGCATGAACGG
ATTTGAGACAGCCGTAAGG -> TTTGAGACAGCCGTAAGGC
ATTTGATTAATTTACCCGG -> TTTGATTAATTTACCCGGA
ATTTGCAACGATTTGGTAT -> TTTGCAACGATTTGGTATT
ATTTGCAGGGCGATCCCCT -> TTTGCAGGGCGATCCCCTG
ATTTGCGTGCTGTCGTCTT -> TTTGCGTGCTGTCGTCTTA
ATTTGGTATTGAAAGGGTG -> TTTGGTATTGAAAGGGTGA
ATTTTTGCCCCGCGTTGGA -> TTTTTGCCCCGCGTTGGAT
ATTTTTTATACCCTTATTA -> TTTTTTATACCCTTATTAA
CAAAACAGATACTCAGGCG -> AAAACAGATACTCAGGCGG
CAAAAGGGGCACTGCATGC -> AAAAGGGGCACTGCATGCT
CAAACCATCATAGGAACAC -> AAACCATCATAGGAACACA
CAAACGCGACTCTACCAAA -> AAACGCGACTCTACCAAAT
CAAACGTAGGTCCATAGTG -> AAACGTAGGTCCATAGTGG
CAAAGAGTTCCTTTAGCAC -> AAAGAGTTCCTTTAGCACC
CAAAGTAGCCCGGCTGATG -> AAAGTAGCCCGGCTGATGG
CAAATAGGAATATCACCGC -> AAATAGGAATATCACCGCA
CAAATCATCTATAGTTCTC -> AAATCATCTATAGTTCTCC
CAAATGCGTTGTTTTTCAG -> AAATGCGTTGTTTTTCAGA
CAAATGCTTTGAAATCCTA -> AAATGCTTTGAAATCCTAT
CAAATTTCCGACTGTTGCG -> AAATTTCCGACTGTTGCGA
CAACAACCCTGGCCGGTCG -> AACAACCCTGGCCGGTCGG
CAACCCTGGCCGGTCGGTT -> AACCCTGGCCGGTCGGTTT
CAACCTTCACGAGGCAAAG -> AACCTTCACGAGGCAAAGT
CAACCTTTGAAAGCTCCAA -> AACCTTTGAAAGCTCCAAT
CAACGATTTGGTATTGAAA -> AACGATTTGGTATTGAAAG
CAACGCTAGGCGATACTAA -> AACGCTAGGCGATACTAAT
CAACTCATAAGGCCGACAG -> AACTCATAAGGCCGACAGT
CAACTCGTGCCATTGATTG -> AACTCGTGCCATTGATTGG
CAACTGCTTCTTTGCCATG -> AACTGCTTCTTTGCCATGT
CAAGAGACAGCACTGTTGA -> AAGAGACAGCACTGTTGAG
CAAGTATCGTCGCACGTCT -> AAGTATCGTCGCACGTCTA
CAAGTGTGTCGACCTCTAG -> AAGTGTGTCGACCTCTAGT
CAAGTTGGGTTTGATTCCA -> AAGTTGGGTTTGATTCCAA
CAATAACGGAGCGATCTCA -> AATAACGGAGCGATCTCAA
CAATCATGAGTAGCCATAG -> AATCATGAGTAGCCATAGA
CAATCGGATTTGAGACAGC -> AATCGGATTTGAGACAGCC
CAATCGGTTTGCTAATTCA -> AATCGGTTTGCTAATTCAG
CAATGAAGCGGCCGATTTG -> AATGAAGCGGCCGATTTGC
CAATGCCCAGACGGCATCC -> AATGCCCAGACGGCATCCC
CAATGCCCCTCATATCTAC -> AATGCCCCTCATATCTACG
CAATTTGATTAATTTACCC -> AATTTGATTAATTTACCCG
CAATTTGCAACGATTTGGT -> AATTTGCAACGATTTGGTA
CACAACGCTAGGCGATACT -> ACAACGCTAGGCGATACTA
CACAATGAAGCGGCCGATT -> ACAATGAAGCGGCCGATTT
CACACTCCAGGAATCATCA -> ACACTCCAGGAATCATCAC
CACAGAGCACAATGAAGCG -> ACAGAGCACAATGAAGCGG
CACAGGGGCATCGGAGTCT -> ACAGGGGCATCGGAGTCTT
CACCAACTGCTTCTTTGCC -> ACCAACTGCTTCTTTGCCA
CACCAGGGTAATGATTATG -> ACCAGGGTAATGATTATGT
CACCCATAACACCAACTGC -> ACCCATAACACCAACTGCT
CACCCATTATTTCCAGCGA -> ACCCATTATTTCCAGCGAG
CACCCATTTGACTATGCAT -> ACCCATTTGACTATGCATG
CACCCCGAACGACCCTACG -> ACCCCGAACGACCCTACGA
CACCGCATGATCCATTAAC -> ACCGCATGATCCATTAACT
CACCGCTTGTTATCCGTGG -> ACCGCTTGTTATCCGTGGG
CACCGTAGGGCCGTCAGGG -> ACCGTAGGGCCGTCAGGGC
CACCGTGTCGCTTCCCTCA -> ACCGTGTCGCTTCCCTCAG
CACCTGCTGTGGTTCTCAG -> ACCTGCTGTGGTTCTCAGC
CACCTGTTGACACCGTAGG -> ACCTGTTGACACCGTAGGG
CACCTTAGCCGGGTACACC -> ACCTTAGCCGGGTACACCC
CACGAGCAGCCGTCAGCGA -> ACGAGCAGCCGTCAGCGAG
CACGAGGCAAAGTAGCCCG -> ACGAGGCAAAGTAGCCCGG
CACGATCCATTGTACATCT -> ACGATCCATTGTACATCTC
CACGCACAACGCTAGGCGA -> ACGCACAACGCTAGGCGAT
CACGCACGCGTAACCACTG -> ACGCACGCGTAACCACTGA
CACGCGTAACCACTGACAG -> ACGCGTAACCACTGACAGA
CACGGCAGATCATTTAATA -> ACGGCAGATCATTTAATAA
CACGGCCATCCAAGTGTGT -> ACGGCCATCCAAGTGTGTC
CACGTCTACAGTCTGGCGC -> ACGTCTACAGTCTGGCGCT
CACTAGATGGCTACCAAAG -> ACTAGATGGCTACCAAAGA
CACTCATTACGCGTCCCAA -> ACTCATTACGCGTCCCAAT
CACTCCAGGAATCATCACC -> ACTCCAGGAATCATCACCC
CACTGACAGAAGCTCAACC -> ACTGACAGAAGCTCAACCT
CACTGACGTTAGGGTAGCT -> ACTGACGTTAGGGTAGCTG
CACTGATACAGTCTTGATG -> ACTGATACAGTCTTGATGG
CACTGCATGCTGGCCCAGT -> ACTGCATGCTGGCCCAGTA
CACTGTTGAGGCGGCGGTC -> ACTGTTGAGGCGGCGGTCC
CAGAAAACTCTACCGCTAC -> AGAAAACTCTACCGCTACC
CAGAACAACCTTTGAAAGC -> AGAACAACCTTTGAAAGCT
CAGAAGCTCAACCTTCACG -> AGAAGCTCAACCTTCACGA
CAGAATGGCGAACCAGTGC -> AGAATGGCGAACCAGTGCA
CAGACACTAGATGGCTACC -> AGACACTAGATGGCTACCA
CAGACGGCATCCCTTGTTG -> AGACGGCATCCCTTGTTGT
CAGAGAAGCCCCCCTGTAA -> AGAGAAGCCCCCCTGTAAG
CAGAGCACAATGAAGCGGC -> AGAGCACAATGAAGCGGCC
CAGAGCCTATAAGGGACGC -> AGAGCCTATAAGGGACGCT
CAGAGGGTGAGGATGTAAC -> AGAGGGTGAGGATGTAACA
CAGATACTCAGGCGGGGAT -> AGATACTCAGGCGGGGATT
CAGATCATTTAATAATTGG -> AGATCATTTAATAATTGGA
CAGCACCCATTTGACTATG -> AGCACCCATTTGACTATGC
CAGCACTGTTGAGGCGGCG -> AGCACTGTTGAGGCGGCGG
CAGCAGAGGGTGAGGATGT -> AGCAGAGGGTGAGGATGTA
CAGCATAATCCATGAAACC -> AGCATAATCCATGAAACCG
CAGCCCTGGACAATTTGAT -> AGCCCTGGACAATTTGATT
CAGCCGTAAGGCCTAGGCG -> AGCCGTAAGGCCTAGGCGT
CAGCCGTCAGCGAGGGTCC -> AGCCGTCAGCGAGGGTCCT
CAGCGAGGGTCCTATCGCA -> AGCGAGGGTCCTATCGCAC
CAGCGAGGTGTTCGCACAG -> AGCGAGGTGTTCGCACAGA
CAGCGCCGCCAAAACAGAT -> AGCGCCGCCAAAACAGATA
CAGCTGTTTTGTTCCAGGG -> AGCTGTTTTGTTCCAGGGC
CAGGAATCATCACCCCGAA -> AGGAATCATCACCCCGAAC
CAGGCGAGCTCGTTGGATA -> AGGCGAGCTCGTTGGATAT
CAGGCGGGGATTCAGTTTA -> AGGCGGGGATTCAGTTTAA
CAGGGCCACGGCCATCCAA -> AGGGCCACGGCCATCCAAG
CAGGGCCAGTGGTACTGCC -> AGGGCCAGTGGTACTGCCG
CAGGGCGATCCCCTGTTCT -> AGGGCGATCCCCTGTTCTA
CAGGGGCATCGGAGTCTTA -> AGGGGCATCGGAGTCTTAC
CAGGGTAATGATTATGTAG -> AGGGTAATGATTATGTAGC
CAGTAGGTCGCACTGATAC -> AGTAGGTCGCACTGATACA
CAGTCCAAATCATCTATAG -> AGTCCAAATCATCTATAGT
CAGTCGCCCTGAACGTCGC -> AGTCGCCCTGAACGTCGCA
CAGTCTTGATGGAATTTGA -> AGTCTTGATGGAATTTGAC
CAGTGCACAGGGGCATCGG -> AGTGCACAGGGGCATCGGA
CAGTGCTTGCTTTGCTTAT -> AGTGCTTGCTTTGCTTATT
CAGTGGTACTGCCGGTGCA -> AGTGGTACTGCCGGTGCAG
CAGTTCATTCACGAGCAGC -> AGTTCATTCACGAGCAGCC
CAGTTTAACTTCATGGTCG -> AGTTTAACTTCATGGTCGC
CATAACACCAACTGCTTCT -> ATAACACCAACTGCTTCTT
CATAAGGCCGACAGTGCTT -> ATAAGGCCGACAGTGCTTG
CATAATCCATGAAACCGGC -> ATAATCCATGAAACCGGCT
CATAGACAGAATGGCGAAC -> ATAGACAGAATGGCGAACC
CATAGGAACACACTCCAGG -> ATAGGAACACACTCCAGGA
CATAGGGTGAACCTCAACT -> ATAGGGTGAACCTCAACTC
CATAGTGGGACGCCGGCTG -> ATAGTGGGACGCCGGCTGA
CATATCGCAAACCATCATA -> ATATCGCAAACCATCATAG
CATATCTACGGGCTCCAAC -> ATATCTACGGGCTCCAACT
CATCACCCCGAACGACCCT -> ATCACCCCGAACGACCCTA
CATCATAGGAACACACTCC -> ATCATAGGAACACACTCCA
CATCCAAGTGTGTCGACCT -> ATCCAAGTGTGTCGACCTC
CATCCCTTGTTGTTCTAGG -> ATCCCTTGTTGTTCTAGGT
CATCGGAGTCTTACGGCTC -> ATCGGAGTCTTACGGCTCC
CATCTATAGTTCTCCCACG -> ATCTATAGTTCTCCCACGC
CATCTCTAGGACGACAAAA -> ATCTCTAGGACGACAAAAG
CATGAAACCGGCTGATGTG -> ATGAAACCGGCTGATGTGG
CATGAACGGCTCATATCGC -> ATGAACGGCTCATATCGCA
CATGAGTAGCCATAGACAG -> ATGAGTAGCCATAGACAGA
CATGATCCATTAACTCCAA -> ATGATCCATTAACTCCAAT
CATGCTGGCCCAGTAGGTC -> ATGCTGGCCCAGTAGGTCG
CATGGCACTCATTACGCGT -> ATGGCACTCATTACGCGTC
CATGGTCGCCTGAGTATCC -> ATGGTCGCCTGAGTATCCG
CATGTCAATTTGCAACGAT -> ATGTCAATTTGCAACGATT
CATGTGATCTACCAATCGG -> ATGTGATCTACCAATCGGA
CATTAACTCCAATAACGGA -> ATTAACTCCAATAACGGAG
CATTACGCGTCCCAATGCC -> ATTACGCGTCCCAATGCCC
CATTATTTCCAGCGAGGTG -> ATTATTTCCAGCGAGGTGT
CATTCACGAGCAGCCGTCA -> ATTCACGAGCAGCCGTCAG
CATTGATTGGTAGACAGAC -> ATTGATTGGTAGACAGACA
CATTGTACATCTCTAGGAC -> ATTGTACATCTCTAGGACG
CATTTAATAATTGGATTGA -> ATTTAATAATTGGATTGAA
CATTTGACTATGCATGAAC -> ATTTGACTATGCATGAACG
CCAAAACAGATACTCAGGC -> CAAAACAGATACTCAGGCG
CCAAACGTAGGTCCATAGT -> CAAACGTAGGTCCATAGTG
CCAAAGAGTTCCTTTAGCA -> CAAAGAGTTCCTTTAGCAC
CCAAATCATCTATAGTTCT -> CAAATCATCTATAGTTCTC
CCAAATGCGTTGTTTTTCA -> CAAATGCGTTGTTTTTCAG
CCAAATTTCCGACTGTTGC -> CAAATTTCCGACTGTTGCG
CCAACAACCCTGGCCGGTC -> CAACAACCCTGGCCGGTCG
CCAACTCATAAGGCCGACA -> CAACTCATAAGGCCGACAG
CCAACTGCTTCTTTGCCAT -> CAACTGCTTCTTTGCCATG
CCAAGTATCGTCGCACGTC -> CAAGTATCGTCGCACGTCT
CCAAGTGTGTCGACCTCTA -> CAAGTGTGTCGACCTCTAG
CCAATAACGGAGCGATCTC -> CAATAACGGAGCGATCTCA
CCAATCATGAGTAGCCATA -> CAATCATGAGTAGCCATAG
CCAATCGGATTTGAGACAG -> CAATCGGATTTGAGACAGC
CCAATGCCCAGACGGCATC -> CAATGCCCAGACGGCATCC
CCACCGTGTCGCTTCCCTC -> CACCGTGTCGCTTCCCTCA
CCACCTGCTGTGGTTCTCA -> CACCTGCTGTGGTTCTCAG
CCACGATCCATTGTACATC -> CACGATCCATTGTACATCT
CCACGCACGCGTAACCACT -> CACGCACGCGTAACCACTG
CCACGGCCATCCAAGTGTG -> CACGGCCATCCAAGTGTGT
CCACTGACAGAAGCTCAAC -> CACTGACAGAAGCTCAACC
CCAGACGGCATCCCTTGTT -> CAGACGGCATCCCTTGTTG
CCAGCGAGGTGTTCGCACA -> CAGCGAGGTGTTCGCACAG
CCAGGAATCATCACCCCGA -> CAGGAATCATCACCCCGAA
CCAGGCGAGCTCGTTGGAT -> CAGGCGAGCTCGTTGGATA
CCAGGGCCAGTGGTACTGC -> CAGGGCCAGTGGTACTGCC
CCAGGGTAATGATTATGTA -> CAGGGTAATGATTATGTAG
CCAGTAGGTCGCACTGATA -> CAGTAGGTCGCACTGATAC
CCAGTGCACAGGGGCATCG -> CAGTGCACAGGGGCATCGG
CCAGTGGTACTGCCGGTGC -> CAGTGGTACTGCCGGTGCA
CCATAACACCAACTGCTTC -> CATAACACCAACTGCTTCT
CCATAGACAGAATGGCGAA -> CATAGACAGAATGGCGAAC
CCATAGTGGGACGCCGGCT -> CATAGTGGGACGCCGGCTG
CCATCATAGGAACACACTC -> CATCATAGGAACACACTCC
CCATCCAAGTGTGTCGACC -> CATCCAAGTGTGTCGACCT
CCATGAAACCGGCTGATGT -> CATGAAACCGGCTGATGTG
CCATGTGATCTACCAATCG -> CATGTGATCTACCAATCGG
CCATTAACTCCAATAACGG -> CATTAACTCCAATAACGGA
CCATTATTTCCAGCGAGGT -> CATTATTTCCAGCGAGGTG
CCATTGATTGGTAGACAGA -> CATTGATTGGTAGACAGAC
CCATTGTACATCTCTAGGA -> CATTGTACATCTCTAGGAC
CCATTTGACTATGCATGAA -> CATTTGACTATGCATGAAC
CCCAATGCCCAGACGGCAT -> CCAATGCCCAGACGGCATC
CCCACCGTGTCGCTTCCCT -> CCACCGTGTCGCTTCCCTC
CCCACCTGCTGTGGTTCTC -> CCACCTGCTGTGGTTCTCA
CCCACGCACGCGTAACCAC -> CCACGCACGCGTAACCACT
CCCAGACGGCATCCCTTGT -> CCAGACGGCATCCCTTGTT
CCCAGTAGGTCGCACTGAT -> CCAGTAGGTCGCACTGATA
CCCATAACACCAACTGCTT -> CCATAACACCAACTGCTTC
CCCATTATTTCCAGCGAGG -> CCATTATTTCCAGCGAGGT
CCCATTTGACTATGCATGA -> CCATTTGACTATGCATGAA
CCCCCCTGTAAGCTGATAA -> CCCCCTGTAAGCTGATAAC
CCCCCTGTAAGCTGATAAC -> CCCCTGTAAGCTGATAACT
CCCCGAACGACCCTACGAT -> CCCGAACGACCCTACGATA
CCCCGCGTTGGATATCTGG -> CCCGCGTTGGATATCTGGG
CCCCTCATATCTACGGGCT -> CCCTCATATCTACGGGCTC
CCCCTGTAAGCTGATAACT -> CCCTGTAAGCTGATAACTT
CCCCTGTTCTATGGGGGGC -> CCCTGTTCTATGGGGGGCA
CCCGAACGACCCTACGATA -> CCGAACGACCCTACGATAG
CCCGCGGGTCTCGGGATGA -> CCGCGGGTCTCGGGATGAG
CCCGCGTTGGATATCTGGG -> CCGCGTTGGATATCTGGGT
CCCGGACACCAGGGTAATG -> CCGGACACCAGGGTAATGA
CCCGGCTGATGGAGGCCCG -> CCGGCTGATGGAGGCCCGC
CCCTACGATAGGGATAAGA -> CCTACGATAGGGATAAGAA
CCCTCAGTCCAAATCATCT -> CCTCAGTCCAAATCATCTA
CCCTCATATCTACGGGCTC -> CCTCATATCTACGGGCTCC
CCCTCCGATGATTTGCGTG -> CCTCCGATGATTTGCGTGC
CCCTGAACGTCGCAATGCC -> CCTGAACGTCGCAATGCCC
CCCTGGACAATTTGATTAA -> CCTGGACAATTTGATTAAT
CCCTGGCCGGTCGGTTTCA -> CCTGGCCGGTCGGTTTCAC
CCCTGTAAGCTGATAACTT -> CCTGTAAGCTGATAACTTG
CCCTGTTCTATGGGGGGCA -> CCTGTTCTATGGGGGGCAA
CCCTTATTAATAGACGGAC -> CCTTATTAATAGACGGACC
CCCTTGTTGTTCTAGGTGA -> CCTTGTTGTTCTAGGTGAG
CCGAACGACCCTACGATAG -> CGAACGACCCTACGATAGG
CCGACAGTGCTTGCTTTGC -> CGACAGTGCTTGCTTTGCT
CCGACTGTTGCGACGGCGC -> CGACTGTTGCGACGGCGCT
CCGAGATATCCGAGTAGCT -> CGAGATATCCGAGTAGCTC
CCGAGCACGGCAGATCATT -> CGAGCACGGCAGATCATTT
CCGAGTAGCTCGGAGTTGT -> CGAGTAGCTCGGAGTTGTT
CCGATGATTTGCGTGCTGT -> CGATGATTTGCGTGCTGTC
CCGATTTGCAGGGCGATCC -> CGATTTGCAGGGCGATCCC
CCGCATGATCCATTAACTC -> CGCATGATCCATTAACTCC
CCGCCAAAACAGATACTCA -> CGCCAAAACAGATACTCAG
CCGCGGGTCTCGGGATGAG -> CGCGGGTCTCGGGATGAGA
CCGCGTTGGATATCTGGGT -> CGCGTTGGATATCTGGGTT
CCGCTACCAAATGCGTTGT -> CGCTACCAAATGCGTTGTT
CCGCTCTCGTGTGGTTTCA -> CGCTCTCGTGTGGTTTCAG
CCGCTGCCCACCTGCTGTG -> CGCTGCCCACCTGCTGTGG
CCGCTTGTTATCCGTGGGT -> CGCTTGTTATCCGTGGGTG
CCGGACACCAGGGTAATGA -> CGGACACCAGGGTAATGAT
CCGGCAGTCGCCCTGAACG -> CGGCAGTCGCCCTGAACGT
CCGGCCCTCCGATGATTTG -> CGGCCCTCCGATGATTTGC
CCGGCTGAGGAGCTTAGGG -> CGGCTGAGGAGCTTAGGGA
CCGGCTGATGGAGGCCCGC -> CGGCTGATGGAGGCCCGCG
CCGGCTGATGTGGCTCGGG -> CGGCTGATGTGGCTCGGGT
CCGGGTACACCCATAACAC -> CGGGTACACCCATAACACC
CCGGTAGCCCACCGTGTCG -> CGGTAGCCCACCGTGTCGC
CCGGTCGGTTTCACGCACA -> CGGTCGGTTTCACGCACAA
CCGGTGCAGCGCCGCCAAA -> CGGTGCAGCGCCGCCAAAA
CCGTAAGGCCTAGGCGTCA -> CGTAAGGCCTAGGCGTCAC
CCGTAGGGCCGTCAGGGCC -> CGTAGGGCCGTCAGGGCCA
CCGTCAGCGAGGGTCCTAT -> CGTCAGCGAGGGTCCTATC
CCGTCAGGGCCACGGCCAT -> CGTCAGGGCCACGGCCATC
CCGTGGGTGACCGGTAGCC -> CGTGGGTGACCGGTAGCCC
CCGTGTCGCTTCCCTCAGT -> CGTGTCGCTTCCCTCAGTC
CCTACGATAGGGATAAGAA -> CTACGATAGGGATAAGAAT
CCTAGGCGTCACTGACGTT -> CTAGGCGTCACTGACGTTA
CCTATAAGGGACGCTTTGG -> CTATAAGGGACGCTTTGGA
CCTATCGCACCGCTTGTTA -> CTATCGCACCGCTTGTTAT
CCTATTATAGGTACTGAAC -> CTATTATAGGTACTGAACT
CCTATTTAAGGTGCTCTCG -> CTATTTAAGGTGCTCTCGA
CCTCAACTCGTGCCATTGA -> CTCAACTCGTGCCATTGAT
CCTCAGCACCCATTTGACT -> CTCAGCACCCATTTGACTA
CCTCAGTCCAAATCATCTA -> CTCAGTCCAAATCATCTAT
CCTCATATCTACGGGCTCC -> CTCATATCTACGGGCTCCA
CCTCCGATGATTTGCGTGC -> CTCCGATGATTTGCGTGCT
CCTCTAGTGGTCTGTCTGC -> CTCTAGTGGTCTGTCTGCA
CCTCTGGTGCTGGAGCGGG -> CTCTGGTGCTGGAGCGGGG
CCTGAACGTCGCAATGCCC -> CTGAACGTCGCAATGCCCC
CCTGAGTATCCGCTCTCGT -> CTGAGTATCCGCTCTCGTG
CCTGCCGGCCCTCCGATGA -> CTGCCGGCCCTCCGATGAT
CCTGCTGTGGTTCTCAGCC -> CTGCTGTGGTTCTCAGCCC
CCTGGACAATTTGATTAAT -> CTGGACAATTTGATTAATT
CCTGGCCGGTCGGTTTCAC -> CTGGCCGGTCGGTTTCACG
CCTGTAAGCTGATAACTTG -> CTGTAAGCTGATAACTTGC
CCTGTTCTATGGGGGGCAA -> CTGTTCTATGGGGGGCAAA
CCTGTTGACACCGTAGGGC -> CTGTTGACACCGTAGGGCC
CCTTAGCCGGGTACACCCA -> CTTAGCCGGGTACACCCAT
CCTTATTAATAGACGGACC -> CTTATTAATAGACGGACCG
CCTTCACGAGGCAAAGTAG -> CTTCACGAGGCAAAGTAGC
CCTTGCTTATAGCACCCAT -> CTTGCTTATAGCACCCATT
CCTTGTTGTTCTAGGTGAG -> CTTGTTGTTCTAGGTGAGG
CCTTTAGCACCTGTTGACA -> CTTTAGCACCTGTTGACAC
CCTTTGAAAGCTCCAATCA -> CTTTGAAAGCTCCAATCAT
CGAAAAACCGAGCACGGCA -> GAAAAACCGAGCACGGCAG
CGAACCAGTGCACAGGGGC -> GAACCAGTGCACAGGGGCA
CGAACCGCTGCCCACCTGC -> GAACCGCTGCCCACCTGCT
CGAACGACCCTACGATAGG -> GAACGACCCTACGATAGGG
CGACAAAAGGGGCACTGCA -> GACAAAAGGGGCACTGCAT
CGACAGTGCTTGCTTTGCT -> GACAGTGCTTGCTTTGCTT
CGACCCTACGATAGGGATA -> GACCCTACGATAGGGATAA
CGACCTCTAGTGGTCTGTC -> GACCTCTAGTGGTCTGTCT
CGACGGCGCTAAATGGCAG -> GACGGCGCTAAATGGCAGC
CGACTCGTTGGATATCTGG -> GACTCGTTGGATATCTGGG
CGACTCTACCAAATTTCCG -> GACTCTACCAAATTTCCGA
CGACTGTTGCGACGGCGCT -> GACTGTTGCGACGGCGCTA
CGAGACGGGGTAGAAAAGA -> GAGACGGGGTAGAAAAGAT
CGAGATATCCGAGTAGCTC -> GAGATATCCGAGTAGCTCG
CGAGCACGGCAGATCATTT -> GAGCACGGCAGATCATTTA
CGAGCAGCCGTCAGCGAGG -> GAGCAGCCGTCAGCGAGGG
CGAGCTCGTTGGATATCTG -> GAGCTCGTTGGATATCTGG
CGAGGCAAAGTAGCCCGGC -> GAGGCAAAGTAGCCCGGCT
CGAGGGTCCTATCGCACCG -> GAGGGTCCTATCGCACCGC
CGAGGTGTTCGCACAGAGC -> GAGGTGTTCGCACAGAGCA
CGAGTAGCTCGGAGTTGTT -> GAGTAGCTCGGAGTTGTTT
CGATACTAATATAGTGTAA -> GATACTAATATAGTGTAAT
CGATAGGGATAAGAATGAG -> GATAGGGATAAGAATGAGT
CGATCCATTGTACATCTCT -> GATCCATTGTACATCTCTA
CGATCCCCTGTTCTATGGG -> GATCCCCTGTTCTATGGGG
CGATCTCAAACGCGACTCT -> GATCTCAAACGCGACTCTA
CGATGATTTGCGTGCTGTC -> GATGATTTGCGTGCTGTCG
CGATTTGCAGGGCGATCCC -> GATTTGCAGGGCGATCCCC
CGATTTGGTATTGAAAGGG -> GATTTGGTATTGAAAGGGT
CGCAAACCATCATAGGAAC -> GCAAACCATCATAGGAACA
CGCAATGCCCCTCATATCT -> GCAATGCCCCTCATATCTA
CGCACAACGCTAGGCGATA -> GCACAACGCTAGGCGATAC
CGCACAGAGCACAATGAAG -> GCACAGAGCACAATGAAGC
CGCACCGCTTGTTATCCGT -> GCACCGCTTGTTATCCGTG
CGCACGCGTAACCACTGAC -> GCACGCGTAACCACTGACA
CGCACGTCTACAGTCTGGC -> GCACGTCTACAGTCTGGCG
CGCACTGATACAGTCTTGA -> GCACTGATACAGTCTTGAT
CGCATGATCCATTAACTCC -> GCATGATCCATTAACTCCA
CGCCAAAACAGATACTCAG -> GCCAAAACAGATACTCAGG
CGCCCTGAACGTCGCAATG -> GCCCTGAACGTCGCAATGC
CGCCGAGATATCCGAGTAG -> GCCGAGATATCCGAGTAGC
CGCCGCCAAAACAGATACT -> GCCGCCAAAACAGATACTC
CGCCGGCTGAGGAGCTTAG -> GCCGGCTGAGGAGCTTAGG
CGCCTGAGTATCCGCTCTC -> GCCTGAGTATCCGCTCTCG
CGCGACTCTACCAAATTTC -> GCGACTCTACCAAATTTCC
CGCGGGTCTCGGGATGAGA -> GCGGGTCTCGGGATGAGAC
CGCGTAACCACTGACAGAA -> GCGTAACCACTGACAGAAG
CGCGTCCCAATGCCCAGAC -> GCGTCCCAATGCCCAGACG
CGCGTTGGATATCTGGGTT -> GCGTTGGATATCTGGGTTC
CGCTAAATGGCAGCAGAGG -> GCTAAATGGCAGCAGAGGG
CGCTACCAAATGCGTTGTT -> GCTACCAAATGCGTTGTTT
CGCTAGGCGATACTAATAT -> GCTAGGCGATACTAATATA
CGCTCCTTGCTTATAGCAC -> GCTCCTTGCTTATAGCACC
CGCTCTCGTGTGGTTTCAG -> GCTCTCGTGTGGTTTCAGC
CGCTGCCCACCTGCTGTGG -> GCTGCCCACCTGCTGTGGT
CGCTTCCCTCAGTCCAAAT -> GCTTCCCTCAGTCCAAATC
CGCTTGTTATCCGTGGGTG -> GCTTGTTATCCGTGGGTGA
CGCTTTGGAGAATGTTTAG -> GCTTTGGAGAATGTTTAGG
CGGAATAAGAACGGCAGAG -> GGAATAAGAACGGCAGAGC
CGGACACCAGGGTAATGAT -> GGACACCAGGGTAATGATT
CGGACCGGCAGTCGCCCTG -> GGACCGGCAGTCGCCCTGA
CGGAGCGATCTCAAACGCG -> GGAGCGATCTCAAACGCGA
CGGAGTCTTACGGCTCCTC -> GGAGTCTTACGGCTCCTCA
CGGAGTTGTTTCGAAAAAC -> GGAGTTGTTTCGAAAAACC
CGGATTTGAGACAGCCGTA -> GGATTTGAGACAGCCGTAA
CGGCAGAGCCTATAAGGGA -> GGCAGAGCCTATAAGGGAC
CGGCAGATCATTTAATAAT -> GGCAGATCATTTAATAATT
CGGCAGTCGCCCTGAACGT -> GGCAGTCGCCCTGAACGTC
CGGCATCCCTTGTTGTTCT -> GGCATCCCTTGTTGTTCTA
CGGCCAAGTATCGTCGCAC -> GGCCAAGTATCGTCGCACG
CGGCCATCCAAGTGTGTCG -> GGCCATCCAAGTGTGTCGA
CGGCCCTCCGATGATTTGC -> GGCCCTCCGATGATTTGCG
CGGCCGATTTGCAGGGCGA -> GGCCGATTTGCAGGGCGAT
CGGCGCTAAATGGCAGCAG -> GGCGCTAAATGGCAGCAGA
CGGCGGTCCTCTGGTGCTG -> GGCGGTCCTCTGGTGCTGG
CGGCTAGTGCGGGTCTCGG -> GGCTAGTGCGGGTCTCGGG
CGGCTCATATCGCAAACCA -> GGCTCATATCGCAAACCAT
CGGCTCCTCAGCACCCATT -> GGCTCCTCAGCACCCATTT
CGGCTGAGGAGCTTAGGGA -> GGCTGAGGAGCTTAGGGAC
CGGCTGATGGAGGCCCGCG -> GGCTGATGGAGGCCCGCGG
CGGCTGATGTGGCTCGGGT -> GGCTGATGTGGCTCGGGTC
CGGGACTTCCAACAACCCT -> GGGACTTCCAACAACCCTG
CGGGATGAGAATGAAGCGA -> GGGATGAGAATGAAGCGAC
CGGGATGAGACCAGGCGAG -> GGGATGAGACCAGGCGAGC
CGGGATGAGAGGCTGAGGA -> GGGATGAGAGGCTGAGGAA
CGGGATGAGATTTTTGCCC -> GGGATGAGATTTTTGCCCC
CGGGCTCCAACTCATAAGG -> GGGCTCCAACTCATAAGGC
CGGGGATTCAGTTTAACTT -> GGGGATTCAGTTTAACTTC
CGGGGCGGGTCTCGGGATG -> GGGGCGGGTCTCGGGATGA
CGGGGTAGAAAAGATTTTT -> GGGGTAGAAAAGATTTTTT
CGGGTACACCCATAACACC -> GGGTACACCCATAACACCA
CGGGTCTCGGGATGAGAAT -> GGGTCTCGGGATGAGAATG
CGGGTCTCGGGATGAGACC -> GGGTCTCGGGATGAGACCA
CGGGTCTCGGGATGAGAGG -> GGGTCTCGGGATGAGAGGC
CGGGTCTCGGGATGAGATT -> GGGTCTCGGGATGAGATTT
CGGGTCTGGTCAAGTTGGG -> GGGTCTGGTCAAGTTGGGT
CGGTAGCCCACCGTGTCGC -> GGTAGCCCACCGTGTCGCT
CGGTCCTCTGGTGCTGGAG -> GGTCCTCTGGTGCTGGAGC
CGGTCGGTTTCACGCACAA -> GGTCGGTTTCACGCACAAC
CGGTGCAGCGCCGCCAAAA -> GGTGCAGCGCCGCCAAAAC
CGGTTTCACGCACAACGCT -> GGTTTCACGCACAACGCTA
CGGTTTGCTAATTCAGTTC -> GGTTTGCTAATTCAGTTCA
CGTAACCACTGACAGAAGC -> GTAACCACTGACAGAAGCT
CGTAAGGCCTAGGCGTCAC -> GTAAGGCCTAGGCGTCACT
CGTAGGGCCGTCAGGGCCA -> GTAGGGCCGTCAGGGCCAC
CGTAGGTCCATAGTGGGAC -> GTAGGTCCATAGTGGGACG
CGTCACTGACGTTAGGGTA -> GTCACTGACGTTAGGGTAG
CGTCAGCGAGGGTCCTATC -> GTCAGCGAGGGTCCTATCG
CGTCAGGGCCACGGCCATC -> GTCAGGGCCACGGCCATCC
CGTCCCAATGCCCAGACGG -> GTCCCAATGCCCAGACGGC
CGTCGCAATGCCCCTCATA -> GTCGCAATGCCCCTCATAT
CGTCGCACGTCTACAGTCT -> GTCGCACGTCTACAGTCTG
CGTCTACAGTCTGGCGCTG -> GTCTACAGTCTGGCGCTGA
CGTCTTAGCGAACCGCTGC -> GTCTTAGCGAACCGCTGCC
CGTGCCATTGATTGGTAGA -> GTGCCATTGATTGGTAGAC
CGTGCTGTCGTCTTAGCGA -> GTGCTGTCGTCTTAGCGAA
CGTGGGTGACCGGTAGCCC -> GTGGGTGACCGGTAGCCCA
CGTGTCGCTTCCCTCAGTC -> GTGTCGCTTCCCTCAGTCC
CGTGTGGTTTCAGCATAAT -> GTGTGGTTTCAGCATAATC
CGTTACTACTTGTAGGCTC -> GTTACTACTTGTAGGCTCG
CGTTAGGGTAGCTGGAGAG -> GTTAGGGTAGCTGGAGAGT
CGTTGGATATCTGGGTTCT -> GTTGGATATCTGGGTTCTA,GTTGGATATCTGGGTTCTA,GTTGGATATCTGGGTTCTG,GTTGGATATCTGGGTTCTT
CGTTGTTTTTCAGAGAAGC -> GTTGTTTTTCAGAGAAGCC
CTAAATGGCAGCAGAGGGT -> TAAATGGCAGCAGAGGGTG
CTAACTGCAGAACAACCTT -> TAACTGCAGAACAACCTTT
CTAAGTATCACCTTAGCCG -> TAAGTATCACCTTAGCCGG
CTAATATAGTGTAATTTAC -> TAATATAGTGTAATTTACC
CTAATTCAGTTCATTCACG -> TAATTCAGTTCATTCACGA
CTACAGTCTGGCGCTGAGG -> TACAGTCTGGCGCTGAGGG
CTACCAAAGAGTTCCTTTA -> TACCAAAGAGTTCCTTTAG
CTACCAAATGCGTTGTTTT -> TACCAAATGCGTTGTTTTT
CTACCAAATTTCCGACTGT -> TACCAAATTTCCGACTGTT
CTACCAATCGGATTTGAGA -> TACCAATCGGATTTGAGAC
CTACCGCTACCAAATGCGT -> TACCGCTACCAAATGCGTT
CTACGATAGGGATAAGAAT -> TACGATAGGGATAAGAATG
CTACGCTCCTTGCTTATAG -> TACGCTCCTTGCTTATAGC
CTACGGGCTCCAACTCATA -> TACGGGCTCCAACTCATAA
CTACTTGTAGGCTCGGCCA -> TACTTGTAGGCTCGGCCAA
CTAGATGGCTACCAAAGAG -> TAGATGGCTACCAAAGAGT
CTAGGACGACAAAAGGGGC -> TAGGACGACAAAAGGGGCA
CTAGGCGATACTAATATAG -> TAGGCGATACTAATATAGT
CTAGGCGTCACTGACGTTA -> TAGGCGTCACTGACGTTAG
CTAGGTGAGGCTTTTGCCT -> TAGGTGAGGCTTTTGCCTG
CTAGTGCGGGTCTCGGGAT -> TAGTGCGGGTCTCGGGATG
CTAGTGGTCTGTCTGCATG -> TAGTGGTCTGTCTGCATGG
CTATAAGGGACGCTTTGGA -> TATAAGGGACGCTTTGGAG
CTATAGTTCTCCCACGCAC -> TATAGTTCTCCCACGCACG
CTATCGCACCGCTTGTTAT -> TATCGCACCGCTTGTTATC
CTATGCATGAACGGCTCAT -> TATGCATGAACGGCTCATA
CTATGGGGGGCAAATGCTT -> TATGGGGGGCAAATGCTTT
CTATTATAGGTACTGAACT -> TATTATAGGTACTGAACTG
CTATTTAAGGTGCTCTCGA -> TATTTAAGGTGCTCTCGAG
CTCAAACGCGACTCTACCA -> TCAAACGCGACTCTACCAA
CTCAACCTTCACGAGGCAA -> TCAACCTTCACGAGGCAAA
CTCAACTCGTGCCATTGAT -> TCAACTCGTGCCATTGATT
CTCAGCACCCATTTGACTA -> TCAGCACCCATTTGACTAT
CTCAGCCCTGGACAATTTG -> TCAGCCCTGGACAATTTGA
CTCAGGCGGGGATTCAGTT -> TCAGGCGGGGATTCAGTTT
CTCAGTCCAAATCATCTAT -> TCAGTCCAAATCATCTATA
CTCATAAGGCCGACAGTGC -> TCATAAGGCCGACAGTGCT
CTCATATCGCAAACCATCA -> TCATATCGCAAACCATCAT
CTCATATCTACGGGCTCCA -> TCATATCTACGGGCTCCAA
CTCATTACGCGTCCCAATG -> TCATTACGCGTCCCAATGC
CTCCAACTCATAAGGCCGA -> TCCAACTCATAAGGCCGAC
CTCCAATAACGGAGCGATC -> TCCAATAACGGAGCGATCT
CTCCAATCATGAGTAGCCA -> TCCAATCATGAGTAGCCAT
CTCCAGGAATCATCACCCC -> TCCAGGAATCATCACCCCG
CTCCCACGCACGCGTAACC -> TCCCACGCACGCGTAACCA
CTCCGATGATTTGCGTGCT -> TCCGATGATTTGCGTGCTG
CTCCTCAGCACCCATTTGA -> TCCTCAGCACCCATTTGAC
CTCCTTGCTTATAGCACCC -> TCCTTGCTTATAGCACCCA
CTCGAGACGGGGTAGAAAA -> TCGAGACGGGGTAGAAAAG
CTCGGAGTTGTTTCGAAAA -> TCGGAGTTGTTTCGAAAAA
CTCGGCCAAGTATCGTCGC -> TCGGCCAAGTATCGTCGCA
CTCGGGATGAGAATGAAGC -> TCGGGATGAGAATGAAGCG
CTCGGGATGAGACCAGGCG -> TCGGGATGAGACCAGGCGA
CTCGGGATGAGAGGCTGAG -> TCGGGATGAGAGGCTGAGG
CTCGGGATGAGATTTTTGC -> TCGGGATGAGATTTTTGCC
CTCGGGTCTGGTCAAGTTG -> TCGGGTCTGGTCAAGTTGG
CTCGTGCCATTGATTGGTA -> TCGTGCCATTGATTGGTAG
CTCGTGTGGTTTCAGCATA -> TCGTGTGGTTTCAGCATAA
CTCGTTGGATATCTGGGTT -> TCGTTGGATATCTGGGTTC,TCGTTGGATATCTGGGTTC
CTCTACCAAATTTCCGACT -> TCTACCAAATTTCCGACTG
CTCTACCGCTACCAAATGC -> TCTACCGCTACCAAATGCG
CTCTAGGACGACAAAAGGG -> TCTAGGACGACAAAAGGGG
CTCTAGTGGTCTGTCTGCA -> TCTAGTGGTCTGTCTGCAT
CTCTCGAGACGGGGTAGAA -> TCTCGAGACGGGGTAGAAA
CTCTCGTGTGGTTTCAGCA -> TCTCGTGTGGTTTCAGCAT
CTCTGGTGCTGGAGCGGGG -> TCTGGTGCTGGAGCGGGGC
CTGAACGTCGCAATGCCCC -> TGAACGTCGCAATGCCCCT
CTGAACTGGGCCTATTTAA -> TGAACTGGGCCTATTTAAG
CTGACAGAAGCTCAACCTT -> TGACAGAAGCTCAACCTTC
CTGACGTTAGGGTAGCTGG -> TGACGTTAGGGTAGCTGGA
CTGAGGAAGCGTTGGATAT -> TGAGGAAGCGTTGGATATC
CTGAGGAGCTTAGGGACAG -> TGAGGAGCTTAGGGACAGA
CTGAGTATCCGCTCTCGTG -> TGAGTATCCGCTCTCGTGT
CTGATAACTTGCTTACATG -> TGATAACTTGCTTACATGT
CTGATACAGTCTTGATGGA -> TGATACAGTCTTGATGGAA
CTGATGGAGGCCCGCGGGT -> TGATGGAGGCCCGCGGGTC
CTGATGTGGCTCGGGTCTG -> TGATGTGGCTCGGGTCTGG
CTGCAAATAGGAATATCAC -> TGCAAATAGGAATATCACC
CTGCAGAACAACCTTTGAA -> TGCAGAACAACCTTTGAAA
CTGCATGCTGGCCCAGTAG -> TGCATGCTGGCCCAGTAGG
CTGCATGGCACTCATTACG -> TGCATGGCACTCATTACGC
CTGCCCACCTGCTGTGGTT -> TGCCCACCTGCTGTGGTTC
CTGCCGGCCCTCCGATGAT -> TGCCGGCCCTCCGATGATT
CTGCCGGTGCAGCGCCGCC -> TGCCGGTGCAGCGCCGCCA
CTGCTGTGGTTCTCAGCCC -> TGCTGTGGTTCTCAGCCCT
CTGCTTCTTTGCCATGTGA -> TGCTTCTTTGCCATGTGAT
CTGGACAATTTGATTAATT -> TGGACAATTTGATTAATTT
CTGGAGAGTTCGGAATAAG -> TGGAGAGTTCGGAATAAGA
CTGGAGCGGGGCGGGTCTC -> TGGAGCGGGGCGGGTCTCG
CTGGCCCAGTAGGTCGCAC -> TGGCCCAGTAGGTCGCACT
CTGGCCGGTCGGTTTCACG -> TGGCCGGTCGGTTTCACGC
CTGGGCCTATTTAAGGTGC -> TGGGCCTATTTAAGGTGCT
CTGGGTTCTAAGTATCACC -> TGGGTTCTAAGTATCACCT
CTGGGTTCTACGCTCCTTG -> TGGGTTCTACGCTCCTTGC
CTGGGTTCTGCAAATAGGA -> TGGGTTCTGCAAATAGGAA
CTGGGTTCTTCGGGACTTC -> TGGGTTCTTCGGGACTTCC
CTGGTCAAGTTGGGTTTGA -> TGGTCAAGTTGGGTTTGAT
CTGGTGCTGGAGCGGGGCG -> TGGTGCTGGAGCGGGGCGG
CTGTAAGCTGATAACTTGC -> TGTAAGCTGATAACTTGCT
CTGTCGTCTTAGCGAACCG -> TGTCGTCTTAGCGAACCGC
CTGTCTGCATGGCACTCAT -> TGTCTGCATGGCACTCATT
CTGTGGTTCTCAGCCCTGG -> TGTGGTTCTCAGCCCTGGA
CTGTTCTATGGGGGGCAAA -> TGTTCTATGGGGGGCAAAT
CTGTTGACACCGTAGGGCC -> TGTTGACACCGTAGGGCCG
CTGTTGAGGCGGCGGTCCT -> TGTTGAGGCGGCGGTCCTC
CTGTTGCGACGGCGCTAAA -> TGTTGCGACGGCGCTAAAT
CTGTTTTGTTCCAGGGCCA -> TGTTTTGTTCCAGGGCCAG
CTTACATGTCAATTTGCAA -> TTACATGTCAATTTGCAAC
CTTACGGCTCCTCAGCACC -> TTACGGCTCCTCAGCACCC
CTTAGCCGGGTACACCCAT -> TTAGCCGGGTACACCCATA
CTTAGCGAACCGCTGCCCA -> TTAGCGAACCGCTGCCCAC
CTTAGGGACAGAAAACTCT -> TTAGGGACAGAAAACTCTA
CTTATAGCACCCATTATTT -> TTATAGCACCCATTATTTC
CTTATTAATAGACGGACCG -> TTATTAATAGACGGACCGG
CTTATTAATCGCCGAGATA -> TTATTAATCGCCGAGATAT
CTTCACGAGGCAAAGTAGC -> TTCACGAGGCAAAGTAGCC
CTTCATGGTCGCCTGAGTA -> TTCATGGTCGCCTGAGTAT
CTTCCAACAACCCTGGCCG -> TTCCAACAACCCTGGCCGG
CTTCCCTCAGTCCAAATCA -> TTCCCTCAGTCCAAATCAT
CTTCGGGACTTCCAACAAC -> TTCGGGACTTCCAACAACC
CTTCTTTGCCATGTGATCT -> TTCTTTGCCATGTGATCTA
CTTGATGGAATTTGACTAA -> TTGATGGAATTTGACTAAC
CTTGCTTACATGTCAATTT -> TTGCTTACATGTCAATTTG
CTTGCTTATAGCACCCATT -> TTGCTTATAGCACCCATTA
CTTGCTTTGCTTATTAATC -> TTGCTTTGCTTATTAATCG
CTTGTAGGCTCGGCCAAGT -> TTGTAGGCTCGGCCAAGTA
CTTGTTATCCGTGGGTGAC -> TTGTTATCCGTGGGTGACC
CTTGTTGTTCTAGGTGAGG -> TTGTTGTTCTAGGTGAGGC
CTTTAGCACCTGTTGACAC -> TTTAGCACCTGTTGACACC
CTTTGAAAGCTCCAATCAT -> TTTGAAAGCTCCAATCATG
CTTTGAAATCCTATTATAG -> TTTGAAATCCTATTATAGG
CTTTGCCATGTGATCTACC -> TTTGCCATGTGATCTACCA
CTTTGCTTATTAATCGCCG -> TTTGCTTATTAATCGCCGA
CTTTGGAGAATGTTTAGGA -> TTTGGAGAATGTTTAGGAA
CTTTTCGGCTAGTGCGGGT -> TTTTCGGCTAGTGCGGGTC
CTTTTGCCTGCCGGCCCTC -> TTTTGCCTGCCGGCCCTCC
GAAAAACCGAGCACGGCAG -> AAAAACCGAGCACGGCAGA
GAAAACTCTACCGCTACCA -> AAAACTCTACCGCTACCAA
GAAAAGATTTTTTATACCC -> AAAAGATTTTTTATACCCT
GAAACCGGCTGATGTGGCT -> AAACCGGCTGATGTGGCTC
GAAAGCTCCAATCATGAGT -> AAAGCTCCAATCATGAGTA
GAAAGGGTGAGAACGTTAC -> AAAGGGTGAGAACGTTACT
GAAAGTCAGCTGTTTTGTT -> AAAGTCAGCTGTTTTGTTC
GAAATCCTATTATAGGTAC -> AAATCCTATTATAGGTACT
GAACAACCTTTGAAAGCTC -> AACAACCTTTGAAAGCTCC
GAACACACTCCAGGAATCA -> AACACACTCCAGGAATCAT
GAACCAGTGCACAGGGGCA -> AACCAGTGCACAGGGGCAT
GAACCGCTGCCCACCTGCT -> AACCGCTGCCCACCTGCTG
GAACCTCAACTCGTGCCAT -> AACCTCAACTCGTGCCATT
GAACGACCCTACGATAGGG -> AACGACCCTACGATAGGGA
GAACGGCAGAGCCTATAAG -> AACGGCAGAGCCTATAAGG
GAACGGCTCATATCGCAAA -> AACGGCTCATATCGCAAAC
GAACGTCGCAATGCCCCTC -> AACGTCGCAATGCCCCTCA
GAACGTTACTACTTGTAGG -> AACGTTACTACTTGTAGGC
GAACTGGGCCTATTTAAGG -> AACTGGGCCTATTTAAGGT
GAAGACAATCGGTTTGCTA -> AAGACAATCGGTTTGCTAA
GAAGCCCCCCTGTAAGCTG -> AAGCCCCCCTGTAAGCTGA
GAAGCGACTCGTTGGATAT -> AAGCGACTCGTTGGATATC
GAAGCGGCCGATTTGCAGG -> AAGCGGCCGATTTGCAGGG
GAAGCGTTGGATATCTGGG -> AAGCGTTGGATATCTGGGT
GAAGCTCAACCTTCACGAG -> AAGCTCAACCTTCACGAGG
GAATAAGAACGGCAGAGCC -> AATAAGAACGGCAGAGCCT
GAATATCACCGCATGATCC -> AATATCACCGCATGATCCA
GAATCATCACCCCGAACGA -> AATCATCACCCCGAACGAC
GAATGAAGCGACTCGTTGG -> AATGAAGCGACTCGTTGGA
GAATGAGTGTAACAAGAGA -> AATGAGTGTAACAAGAGAC
GAATGGCGAACCAGTGCAC -> AATGGCGAACCAGTGCACA
GAATGTTTAGGAAAGTCAG -> AATGTTTAGGAAAGTCAGC
GAATTTGACTAACTGCAGA -> AATTTGACTAACTGCAGAA
GACAAAAGGGGCACTGCAT -> ACAAAAGGGGCACTGCATG
GACAATCGGTTTGCTAATT -> ACAATCGGTTTGCTAATTC
GACAATTTGATTAATTTAC -> ACAATTTGATTAATTTACC
GACACCAGGGTAATGATTA -> ACACCAGGGTAATGATTAT
GACACCGTAGGGCCGTCAG -> ACACCGTAGGGCCGTCAGG
GACACTAGATGGCTACCAA -> ACACTAGATGGCTACCAAA
GACAGAAAACTCTACCGCT -> ACAGAAAACTCTACCGCTA
GACAGAAGCTCAACCTTCA -> ACAGAAGCTCAACCTTCAC
GACAGAATGGCGAACCAGT -> ACAGAATGGCGAACCAGTG
GACAGACACTAGATGGCTA -> ACAGACACTAGATGGCTAC
GACAGCACTGTTGAGGCGG -> ACAGCACTGTTGAGGCGGC
GACAGCCGTAAGGCCTAGG -> ACAGCCGTAAGGCCTAGGC
GACAGTGCTTGCTTTGCTT -> ACAGTGCTTGCTTTGCTTA
GACCAGGCGAGCTCGTTGG -> ACCAGGCGAGCTCGTTGGA
GACCCTACGATAGGGATAA -> ACCCTACGATAGGGATAAG
GACCGGCAGTCGCCCTGAA -> ACCGGCAGTCGCCCTGAAC
GACCGGTAGCCCACCGTGT -> ACCGGTAGCCCACCGTGTC
GACCTCTAGTGGTCTGTCT -> ACCTCTAGTGGTCTGTCTG
GACGACAAAAGGGGCACTG -> ACGACAAAAGGGGCACTGC
GACGCCGGCTGAGGAGCTT -> ACGCCGGCTGAGGAGCTTA
GACGCTTTGGAGAATGTTT -> ACGCTTTGGAGAATGTTTA
GACGGACCGGCAGTCGCCC -> ACGGACCGGCAGTCGCCCT
GACGGCATCCCTTGTTGTT -> ACGGCATCCCTTGTTGTTC
GACGGCGCTAAATGGCAGC -> ACGGCGCTAAATGGCAGCA
GACGGGGTAGAAAAGATTT -> ACGGGGTAGAAAAGATTTT
GACGTTAGGGTAGCTGGAG -> ACGTTAGGGTAGCTGGAGA
GACTAACTGCAGAACAACC -> ACTAACTGCAGAACAACCT
GACTATGCATGAACGGCTC -> ACTATGCATGAACGGCTCA
GACTCGTTGGATATCTGGG -> ACTCGTTGGATATCTGGGT
GACTCTACCAAATTTCCGA -> ACTCTACCAAATTTCCGAC
GACTGTTGCGACGGCGCTA -> ACTGTTGCGACGGCGCTAA
GACTTCCAACAACCCTGGC -> ACTTCCAACAACCCTGGCC
GAGAACGTTACTACTTGTA -> AGAACGTTACTACTTGTAG
GAGAAGCCCCCCTGTAAGC -> AGAAGCCCCCCTGTAAGCT
GAGAATGAAGCGACTCGTT -> AGAATGAAGCGACTCGTTG
GAGAATGTTTAGGAAAGTC -> AGAATGTTTAGGAAAGTCA
GAGACAGCACTGTTGAGGC -> AGACAGCACTGTTGAGGCG
GAGACAGCCGTAAGGCCTA -> AGACAGCCGTAAGGCCTAG
GAGACCAGGCGAGCTCGTT -> AGACCAGGCGAGCTCGTTG
GAGACGGGGTAGAAAAGAT -> AGACGGGGTAGAAAAGATT
GAGAGGCTGAGGAAGCGTT -> AGAGGCTGAGGAAGCGTTG
GAGAGTTCGGAATAAGAAC -> AGAGTTCGGAATAAGAACG
GAGATATCCGAGTAGCTCG -> AGATATCCGAGTAGCTCGG
GAGATTTTTGCCCCGCGTT -> AGATTTTTGCCCCGCGTTG
GAGCACAATGAAGCGGCCG -> AGCACAATGAAGCGGCCGA
GAGCACGGCAGATCATTTA -> AGCACGGCAGATCATTTAA
GAGCAGCCGTCAGCGAGGG -> AGCAGCCGTCAGCGAGGGT
GAGCCTATAAGGGACGCTT -> AGCCTATAAGGGACGCTTT
GAGCGATCTCAAACGCGAC -> AGCGATCTCAAACGCGACT
GAGCGGGGCGGGTCTCGGG -> AGCGGGGCGGGTCTCGGGA
GAGCTCGTTGGATATCTGG -> AGCTCGTTGGATATCTGGG
GAGCTTAGGGACAGAAAAC -> AGCTTAGGGACAGAAAACT
GAGGAAGCGTTGGATATCT -> AGGAAGCGTTGGATATCTG
GAGGAGCTTAGGGACAGAA -> AGGAGCTTAGGGACAGAAA
GAGGATGTAACATAGGGTG -> AGGATGTAACATAGGGTGA
GAGGCAAAGTAGCCCGGCT -> AGGCAAAGTAGCCCGGCTG
GAGGCCCGCGGGTCTCGGG -> AGGCCCGCGGGTCTCGGGA
GAGGCGGCGGTCCTCTGGT -> AGGCGGCGGTCCTCTGGTG
GAGGCTGAGGAAGCGTTGG -> AGGCTGAGGAAGCGTTGGA
GAGGCTTTTGCCTGCCGGC -> AGGCTTTTGCCTGCCGGCC
GAGGGTCCTATCGCACCGC -> AGGGTCCTATCGCACCGCT
GAGGGTGAGGATGTAACAT -> AGGGTGAGGATGTAACATA
GAGGTGTTCGCACAGAGCA -> AGGTGTTCGCACAGAGCAC
GAGTAGCCATAGACAGAAT -> AGTAGCCATAGACAGAATG
GAGTAGCTCGGAGTTGTTT -> AGTAGCTCGGAGTTGTTTC
GAGTATCCGCTCTCGTGTG -> AGTATCCGCTCTCGTGTGG
GAGTCTTACGGCTCCTCAG -> AGTCTTACGGCTCCTCAGC
GAGTGTAACAAGAGACAGC -> AGTGTAACAAGAGACAGCA
GAGTTCCTTTAGCACCTGT -> AGTTCCTTTAGCACCTGTT
GAGTTCGGAATAAGAACGG -> AGTTCGGAATAAGAACGGC
GAGTTGTTTCGAAAAACCG -> AGTTGTTTCGAAAAACCGA
GATAACTTGCTTACATGTC -> ATAACTTGCTTACATGTCA
GATAAGAATGAGTGTAACA -> ATAAGAATGAGTGTAACAA
GATACAGTCTTGATGGAAT -> ATACAGTCTTGATGGAATT
GATACTAATATAGTGTAAT -> ATACTAATATAGTGTAATT
GATACTCAGGCGGGGATTC -> ATACTCAGGCGGGGATTCA
GATAGGGATAAGAATGAGT -> ATAGGGATAAGAATGAGTG
GATATCCGAGTAGCTCGGA -> ATATCCGAGTAGCTCGGAG
GATATCTGGGTTCTAAGTA -> ATATCTGGGTTCTAAGTAT
GATATCTGGGTTCTACGCT -> ATATCTGGGTTCTACGCTC
GATATCTGGGTTCTGCAAA -> ATATCTGGGTTCTGCAAAT
GATATCTGGGTTCTTCGGG -> ATATCTGGGTTCTTCGGGA
GATCATTTAATAATTGGAT -> ATCATTTAATAATTGGATT
GATCCATTAACTCCAATAA -> ATCCATTAACTCCAATAAC
GATCCATTGTACATCTCTA -> ATCCATTGTACATCTCTAG
GATCCCCTGTTCTATGGGG -> ATCCCCTGTTCTATGGGGG
GATCTACCAATCGGATTTG -> ATCTACCAATCGGATTTGA
GATCTCAAACGCGACTCTA -> ATCTCAAACGCGACTCTAC
GATGAGAATGAAGCGACTC -> ATGAGAATGAAGCGACTCG
GATGAGACCAGGCGAGCTC -> ATGAGACCAGGCGAGCTCG
GATGAGAGGCTGAGGAAGC -> ATGAGAGGCTGAGGAAGCG
GATGAGATTTTTGCCCCGC -> ATGAGATTTTTGCCCCGCG
GATGATTTGCGTGCTGTCG -> ATGATTTGCGTGCTGTCGT
GATGGAATTTGACTAACTG -> ATGGAATTTGACTAACTGC
GATGGAGGCCCGCGGGTCT -> ATGGAGGCCCGCGGGTCTC
GATGGCTACCAAAGAGTTC -> ATGGCTACCAAAGAGTTCC
GATGTAACATAGGGTGAAC -> ATGTAACATAGGGTGAACC
GATGTGGCTCGGGTCTGGT -> ATGTGGCTCGGGTCTGGTC
GATTAATTTACCCGGACAC -> ATTAATTTACCCGGACACC
GATTATGTAGCGGGTCTCG -> ATTATGTAGCGGGTCTCGG
GATTCAGTTTAACTTCATG -> ATTCAGTTTAACTTCATGG
GATTCCAAACGTAGGTCCA -> ATTCCAAACGTAGGTCCAT
GATTGAAGACAATCGGTTT -> ATTGAAGACAATCGGTTTG
GATTGGTAGACAGACACTA -> ATTGGTAGACAGACACTAG
GATTTGAGACAGCCGTAAG -> ATTTGAGACAGCCGTAAGG
GATTTGCAGGGCGATCCCC -> ATTTGCAGGGCGATCCCCT
GATTTGCGTGCTGTCGTCT -> ATTTGCGTGCTGTCGTCTT
GATTTGGTATTGAAAGGGT -> ATTTGGTATTGAAAGGGTG
GATTTTTGCCCCGCGTTGG -> ATTTTTGCCCCGCGTTGGA
GATTTTTTATACCCTTATT -> ATTTTTTATACCCTTATTA
GCAAACCATCATAGGAACA -> CAAACCATCATAGGAACAC
GCAAAGTAGCCCGGCTGAT -> CAAAGTAGCCCGGCTGATG
GCAAATAGGAATATCACCG -> CAAATAGGAATATCACCGC
GCAAATGCTTTGAAATCCT -> CAAATGCTTTGAAATCCTA
GCAACGATTTGGTATTGAA -> CAACGATTTGGTATTGAAA
GCAATGCCCCTCATATCTA -> CAATGCCCCTCATATCTAC
GCACAACGCTAGGCGATAC -> CACAACGCTAGGCGATACT
GCACAATGAAGCGGCCGAT -> CACAATGAAGCGGCCGATT
GCACAGAGCACAATGAAGC -> CACAGAGCACAATGAAGCG
GCACAGGGGCATCGGAGTC -> CACAGGGGCATCGGAGTCT
GCACCCATTATTTCCAGCG -> CACCCATTATTTCCAGCGA
GCACCCATTTGACTATGCA -> CACCCATTTGACTATGCAT
GCACCGCTTGTTATCCGTG -> CACCGCTTGTTATCCGTGG
GCACCTGTTGACACCGTAG -> CACCTGTTGACACCGTAGG
GCACGCGTAACCACTGACA -> CACGCGTAACCACTGACAG
GCACGGCAGATCATTTAAT -> CACGGCAGATCATTTAATA
GCACGTCTACAGTCTGGCG -> CACGTCTACAGTCTGGCGC
GCACTCATTACGCGTCCCA -> CACTCATTACGCGTCCCAA
GCACTGATACAGTCTTGAT -> CACTGATACAGTCTTGATG
GCACTGCATGCTGGCCCAG -> CACTGCATGCTGGCCCAGT
GCACTGTTGAGGCGGCGGT -> CACTGTTGAGGCGGCGGTC
GCAGAACAACCTTTGAAAG -> CAGAACAACCTTTGAAAGC
GCAGAGCCTATAAGGGACG -> CAGAGCCTATAAGGGACGC
GCAGAGGGTGAGGATGTAA -> CAGAGGGTGAGGATGTAAC
GCAGATCATTTAATAATTG -> CAGATCATTTAATAATTGG
GCAGCAGAGGGTGAGGATG -> CAGCAGAGGGTGAGGATGT
GCAGCCGTCAGCGAGGGTC -> CAGCCGTCAGCGAGGGTCC
GCAGCGCCGCCAAAACAGA -> CAGCGCCGCCAAAACAGAT
GCAGGGCGATCCCCTGTTC -> CAGGGCGATCCCCTGTTCT
GCAGTCGCCCTGAACGTCG -> CAGTCGCCCTGAACGTCGC
GCATAATCCATGAAACCGG -> CATAATCCATGAAACCGGC
GCATCCCTTGTTGTTCTAG -> CATCCCTTGTTGTTCTAGG
GCATCGGAGTCTTACGGCT -> CATCGGAGTCTTACGGCTC
GCATGAACGGCTCATATCG -> CATGAACGGCTCATATCGC
GCATGATCCATTAACTCCA -> CATGATCCATTAACTCCAA
GCATGCTGGCCCAGTAGGT -> CATGCTGGCCCAGTAGGTC
GCATGGCACTCATTACGCG -> CATGGCACTCATTACGCGT
GCCAAAACAGATACTCAGG -> CCAAAACAGATACTCAGGC
GCCAAGTATCGTCGCACGT -> CCAAGTATCGTCGCACGTC
GCCACGGCCATCCAAGTGT -> CCACGGCCATCCAAGTGTG
GCCAGTGGTACTGCCGGTG -> CCAGTGGTACTGCCGGTGC
GCCATAGACAGAATGGCGA -> CCATAGACAGAATGGCGAA
GCCATCCAAGTGTGTCGAC -> CCATCCAAGTGTGTCGACC
GCCATGTGATCTACCAATC -> CCATGTGATCTACCAATCG
GCCATTGATTGGTAGACAG -> CCATTGATTGGTAGACAGA
GCCCACCGTGTCGCTTCCC -> CCCACCGTGTCGCTTCCCT
GCCCACCTGCTGTGGTTCT -> CCCACCTGCTGTGGTTCTC
GCCCAGACGGCATCCCTTG -> CCCAGACGGCATCCCTTGT
GCCCAGTAGGTCGCACTGA -> CCCAGTAGGTCGCACTGAT
GCCCCCCTGTAAGCTGATA -> CCCCCCTGTAAGCTGATAA
GCCCCGCGTTGGATATCTG -> CCCCGCGTTGGATATCTGG
GCCCCTCATATCTACGGGC -> CCCCTCATATCTACGGGCT
GCCCGCGGGTCTCGGGATG -> CCCGCGGGTCTCGGGATGA
GCCCGGCTGATGGAGGCCC -> CCCGGCTGATGGAGGCCCG
GCCCTCCGATGATTTGCGT -> CCCTCCGATGATTTGCGTG
GCCCTGAACGTCGCAATGC -> CCCTGAACGTCGCAATGCC
GCCCTGGACAATTTGATTA -> CCCTGGACAATTTGATTAA
GCCGACAGTGCTTGCTTTG -> CCGACAGTGCTTGCTTTGC
GCCGAGATATCCGAGTAGC -> CCGAGATATCCGAGTAGCT
GCCGATTTGCAGGGCGATC -> CCGATTTGCAGGGCGATCC
GCCGCCAAAACAGATACTC -> CCGCCAAAACAGATACTCA
GCCGGCCCTCCGATGATTT -> CCGGCCCTCCGATGATTTG
GCCGGCTGAGGAGCTTAGG -> CCGGCTGAGGAGCTTAGGG
GCCGGGTACACCCATAACA -> CCGGGTACACCCATAACAC
GCCGGTCGGTTTCACGCAC -> CCGGTCGGTTTCACGCACA
GCCGGTGCAGCGCCGCCAA -> CCGGTGCAGCGCCGCCAAA
GCCGTAAGGCCTAGGCGTC -> CCGTAAGGCCTAGGCGTCA
GCCGTCAGCGAGGGTCCTA -> CCGTCAGCGAGGGTCCTAT
GCCGTCAGGGCCACGGCCA -> CCGTCAGGGCCACGGCCAT
GCCTAGGCGTCACTGACGT -> CCTAGGCGTCACTGACGTT
GCCTATAAGGGACGCTTTG -> CCTATAAGGGACGCTTTGG
GCCTATTTAAGGTGCTCTC -> CCTATTTAAGGTGCTCTCG
GCCTGAGTATCCGCTCTCG -> CCTGAGTATCCGCTCTCGT
GCCTGCCGGCCCTCCGATG -> CCTGCCGGCCCTCCGATGA
GCGAACCAGTGCACAGGGG -> CGAACCAGTGCACAGGGGC
GCGAACCGCTGCCCACCTG -> CGAACCGCTGCCCACCTGC
GCGACGGCGCTAAATGGCA -> CGACGGCGCTAAATGGCAG
GCGACTCGTTGGATATCTG -> CGACTCGTTGGATATCTGG
GCGACTCTACCAAATTTCC -> CGACTCTACCAAATTTCCG
GCGAGCTCGTTGGATATCT -> CGAGCTCGTTGGATATCTG
GCGAGGGTCCTATCGCACC -> CGAGGGTCCTATCGCACCG
GCGAGGTGTTCGCACAGAG -> CGAGGTGTTCGCACAGAGC
GCGATACTAATATAGTGTA -> CGATACTAATATAGTGTAA
GCGATCCCCTGTTCTATGG -> CGATCCCCTGTTCTATGGG
GCGATCTCAAACGCGACTC -> CGATCTCAAACGCGACTCT
GCGCCGCCAAAACAGATAC -> CGCCGCCAAAACAGATACT
GCGCTAAATGGCAGCAGAG -> CGCTAAATGGCAGCAGAGG
GCGGCCGATTTGCAGGGCG -> CGGCCGATTTGCAGGGCGA
GCGGCGGTCCTCTGGTGCT -> CGGCGGTCCTCTGGTGCTG
GCGGGGATTCAGTTTAACT -> CGGGGATTCAGTTTAACTT
GCGGGGCGGGTCTCGGGAT -> CGGGGCGGGTCTCGGGATG
GCGGGTCTCGGGATGAGAA -> CGGGTCTCGGGATGAGAAT
GCGGGTCTCGGGATGAGAC -> CGGGTCTCGGGATGAGACC
GCGGGTCTCGGGATGAGAG -> CGGGTCTCGGGATGAGAGG
GCGGGTCTCGGGATGAGAT -> CGGGTCTCGGGATGAGATT
GCGGTCCTCTGGTGCTGGA -> CGGTCCTCTGGTGCTGGAG
GCGTAACCACTGACAGAAG -> CGTAACCACTGACAGAAGC
GCGTCACTGACGTTAGGGT -> CGTCACTGACGTTAGGGTA
GCGTCCCAATGCCCAGACG -> CGTCCCAATGCCCAGACGG
GCGTGCTGTCGTCTTAGCG -> CGTGCTGTCGTCTTAGCGA
GCGTTGGATATCTGGGTTC -> CGTTGGATATCTGGGTTCT,CGTTGGATATCTGGGTTCT
GCGTTGTTTTTCAGAGAAG -> CGTTGTTTTTCAGAGAAGC
GCTAAATGGCAGCAGAGGG -> CTAAATGGCAGCAGAGGGT
GCTAATTCAGTTCATTCAC -> CTAATTCAGTTCATTCACG
GCTACCAAAGAGTTCCTTT -> CTACCAAAGAGTTCCTTTA
GCTACCAAATGCGTTGTTT -> CTACCAAATGCGTTGTTTT
GCTAGGCGATACTAATATA -> CTAGGCGATACTAATATAG
GCTAGTGCGGGTCTCGGGA -> CTAGTGCGGGTCTCGGGAT
GCTCAACCTTCACGAGGCA -> CTCAACCTTCACGAGGCAA
GCTCATATCGCAAACCATC -> CTCATATCGCAAACCATCA
GCTCCAACTCATAAGGCCG -> CTCCAACTCATAAGGCCGA
GCTCCAATCATGAGTAGCC -> CTCCAATCATGAGTAGCCA
GCTCCTCAGCACCCATTTG -> CTCCTCAGCACCCATTTGA
GCTCCTTGCTTATAGCACC -> CTCCTTGCTTATAGCACCC
GCTCGGAGTTGTTTCGAAA -> CTCGGAGTTGTTTCGAAAA
GCTCGGCCAAGTATCGTCG -> CTCGGCCAAGTATCGTCGC
GCTCGGGTCTGGTCAAGTT -> CTCGGGTCTGGTCAAGTTG
GCTCGTTGGATATCTGGGT -> CTCGTTGGATATCTGGGTT
GCTCTCGAGACGGGGTAGA -> CTCTCGAGACGGGGTAGAA
GCTCTCGTGTGGTTTCAGC -> CTCTCGTGTGGTTTCAGCA
GCTGAGGAAGCGTTGGATA -> CTGAGGAAGCGTTGGATAT
GCTGAGGAGCTTAGGGACA -> CTGAGGAGCTTAGGGACAG
GCTGATAACTTGCTTACAT -> CTGATAACTTGCTTACATG
GCTGATGGAGGCCCGCGGG -> CTGATGGAGGCCCGCGGGT
GCTGATGTGGCTCGGGTCT -> CTGATGTGGCTCGGGTCTG
GCTGCCCACCTGCTGTGGT -> CTGCCCACCTGCTGTGGTT
GCTGGAGAGTTCGGAATAA -> CTGGAGAGTTCGGAATAAG
GCTGGAGCGGGGCGGGTCT -> CTGGAGCGGGGCGGGTCTC
GCTGGCCCAGTAGGTCGCA -> CTGGCCCAGTAGGTCGCAC
GCTGTCGTCTTAGCGAACC -> CTGTCGTCTTAGCGAACCG
GCTGTGGTTCTCAGCCCTG -> CTGTGGTTCTCAGCCCTGG
GCTGTTTTGTTCCAGGGCC -> CTGTTTTGTTCCAGGGCCA
GCTTACATGTCAATTTGCA -> CTTACATGTCAATTTGCAA
GCTTAGGGACAGAAAACTC -> CTTAGGGACAGAAAACTCT
GCTTATAGCACCCATTATT -> CTTATAGCACCCATTATTT
GCTTATTAATCGCCGAGAT -> CTTATTAATCGCCGAGATA
GCTTCCCTCAGTCCAAATC -> CTTCCCTCAGTCCAAATCA
GCTTCTTTGCCATGTGATC -> CTTCTTTGCCATGTGATCT
GCTTGCTTTGCTTATTAAT -> CTTGCTTTGCTTATTAATC
GCTTGTTATCCGTGGGTGA -> CTTGTTATCCGTGGGTGAC
GCTTTGAAATCCTATTATA -> CTTTGAAATCCTATTATAG
GCTTTGCTTATTAATCGCC -> CTTTGCTTATTAATCGCCG
GCTTTGGAGAATGTTTAGG -> CTTTGGAGAATGTTTAGGA
GCTTTTGCCTGCCGGCCCT -> CTTTTGCCTGCCGGCCCTC
GGAAAGTCAGCTGTTTTGT -> GAAAGTCAGCTGTTTTGTT
GGAACACACTCCAGGAATC -> GAACACACTCCAGGAATCA
GGAAGCGTTGGATATCTGG -> GAAGCGTTGGATATCTGGG
GGAATAAGAACGGCAGAGC -> GAATAAGAACGGCAGAGCC
GGAATATCACCGCATGATC -> GAATATCACCGCATGATCC
GGAATCATCACCCCGAACG -> GAATCATCACCCCGAACGA
GGAATTTGACTAACTGCAG -> GAATTTGACTAACTGCAGA
GGACAATTTGATTAATTTA -> GACAATTTGATTAATTTAC
GGACACCAGGGTAATGATT -> GACACCAGGGTAATGATTA
GGACAGAAAACTCTACCGC -> GACAGAAAACTCTACCGCT
GGACCGGCAGTCGCCCTGA -> GACCGGCAGTCGCCCTGAA
GGACGACAAAAGGGGCACT -> GACGACAAAAGGGGCACTG
GGACGCCGGCTGAGGAGCT -> GACGCCGGCTGAGGAGCTT
GGACGCTTTGGAGAATGTT -> GACGCTTTGGAGAATGTTT
GGACTTCCAACAACCCTGG -> GACTTCCAACAACCCTGGC
GGAGAATGTTTAGGAAAGT -> GAGAATGTTTAGGAAAGTC
GGAGAGTTCGGAATAAGAA -> GAGAGTTCGGAATAAGAAC
GGAGCGATCTCAAACGCGA -> GAGCGATCTCAAACGCGAC
GGAGCGGGGCGGGTCTCGG -> GAGCGGGGCGGGTCTCGGG
GGAGCTTAGGGACAGAAAA -> GAGCTTAGGGACAGAAAAC
GGAGGCCCGCGGGTCTCGG -> GAGGCCCGCGGGTCTCGGG
GGAGTCTTACGGCTCCTCA -> GAGTCTTACGGCTCCTCAG
GGAGTTGTTTCGAAAAACC -> GAGTTGTTTCGAAAAACCG
GGATAAGAATGAGTGTAAC -> GATAAGAATGAGTGTAACA
GGATATCTGGGTTCTAAGT -> GATATCTGGGTTCTAAGTA
GGATATCTGGGTTCTACGC -> GATATCTGGGTTCTACGCT
GGATATCTGGGTTCTGCAA -> GATATCTGGGTTCTGCAAA
GGATATCTGGGTTCTTCGG -> GATATCTGGGTTCTTCGGG
GGATGAGAATGAAGCGACT -> GATGAGAATGAAGCGACTC
GGATGAGACCAGGCGAGCT -> GATGAGACCAGGCGAGCTC
GGATGAGAGGCTGAGGAAG -> GATGAGAGGCTGAGGAAGC
GGATGAGATTTTTGCCCCG -> GATGAGATTTTTGCCCCGC
GGATGTAACATAGGGTGAA -> GATGTAACATAGGGTGAAC
GGATTCAGTTTAACTTCAT -> GATTCAGTTTAACTTCATG
GGATTGAAGACAATCGGTT -> GATTGAAGACAATCGGTTT
GGATTTGAGACAGCCGTAA -> GATTTGAGACAGCCGTAAG
GGCAAAGTAGCCCGGCTGA -> GCAAAGTAGCCCGGCTGAT
GGCAAATGCTTTGAAATCC -> GCAAATGCTTTGAAATCCT
GGCACTCATTACGCGTCCC -> GCACTCATTACGCGTCCCA
GGCACTGCATGCTGGCCCA -> GCACTGCATGCTGGCCCAG
GGCAGAGCCTATAAGGGAC -> GCAGAGCCTATAAGGGACG
GGCAGATCATTTAATAATT -> GCAGATCATTTAATAATTG
GGCAGCAGAGGGTGAGGAT -> GCAGCAGAGGGTGAGGATG
GGCAGTCGCCCTGAACGTC -> GCAGTCGCCCTGAACGTCG
GGCATCCCTTGTTGTTCTA -> GCATCCCTTGTTGTTCTAG
GGCATCGGAGTCTTACGGC -> GCATCGGAGTCTTACGGCT
GGCCAAGTATCGTCGCACG -> GCCAAGTATCGTCGCACGT
GGCCACGGCCATCCAAGTG -> GCCACGGCCATCCAAGTGT
GGCCAGTGGTACTGCCGGT -> GCCAGTGGTACTGCCGGTG
GGCCATCCAAGTGTGTCGA -> GCCATCCAAGTGTGTCGAC
GGCCCAGTAGGTCGCACTG -> GCCCAGTAGGTCGCACTGA
GGCCCGCGGGTCTCGGGAT -> GCCCGCGGGTCTCGGGATG
GGCCCTCCGATGATTTGCG -> GCCCTCCGATGATTTGCGT
GGCCGACAGTGCTTGCTTT -> GCCGACAGTGCTTGCTTTG
GGCCGATTTGCAGGGCGAT -> GCCGATTTGCAGGGCGATC
GGCCGGTCGGTTTCACGCA -> GCCGGTCGGTTTCACGCAC
GGCCGTCAGGGCCACGGCC -> GCCGTCAGGGCCACGGCCA
GGCCTAGGCGTCACTGACG -> GCCTAGGCGTCACTGACGT
GGCCTATTTAAGGTGCTCT -> GCCTATTTAAGGTGCTCTC
GGCGAACCAGTGCACAGGG -> GCGAACCAGTGCACAGGGG
GGCGAGCTCGTTGGATATC -> GCGAGCTCGTTGGATATCT
GGCGATACTAATATAGTGT -> GCGATACTAATATAGTGTA
GGCGATCCCCTGTTCTATG -> GCGATCCCCTGTTCTATGG
GGCGCTAAATGGCAGCAGA -> GCGCTAAATGGCAGCAGAG
GGCGGCGGTCCTCTGGTGC -> GCGGCGGTCCTCTGGTGCT
GGCGGGGATTCAGTTTAAC -> GCGGGGATTCAGTTTAACT
GGCGGGTCTCGGGATGAGA -> GCGGGTCTCGGGATGAGAG
GGCGGTCCTCTGGTGCTGG -> GCGGTCCTCTGGTGCTGGA
GGCGTCACTGACGTTAGGG -> GCGTCACTGACGTTAGGGT
GGCTACCAAAGAGTTCCTT -> GCTACCAAAGAGTTCCTTT
GGCTAGTGCGGGTCTCGGG -> GCTAGTGCGGGTCTCGGGA
GGCTCATATCGCAAACCAT -> GCTCATATCGCAAACCATC
GGCTCCAACTCATAAGGCC -> GCTCCAACTCATAAGGCCG
GGCTCCTCAGCACCCATTT -> GCTCCTCAGCACCCATTTG
GGCTCGGCCAAGTATCGTC -> GCTCGGCCAAGTATCGTCG
GGCTCGGGTCTGGTCAAGT -> GCTCGGGTCTGGTCAAGTT
GGCTGAGGAAGCGTTGGAT -> GCTGAGGAAGCGTTGGATA
GGCTGAGGAGCTTAGGGAC -> GCTGAGGAGCTTAGGGACA
GGCTGATGGAGGCCCGCGG -> GCTGATGGAGGCCCGCGGG
GGCTGATGTGGCTCGGGTC -> GCTGATGTGGCTCGGGTCT
GGCTTTTGCCTGCCGGCCC -> GCTTTTGCCTGCCGGCCCT
GGGACAGAAAACTCTACCG -> GGACAGAAAACTCTACCGC
GGGACGCCGGCTGAGGAGC -> GGACGCCGGCTGAGGAGCT
GGGACGCTTTGGAGAATGT -> GGACGCTTTGGAGAATGTT
GGGACTTCCAACAACCCTG -> GGACTTCCAACAACCCTGG
GGGATAAGAATGAGTGTAA -> GGATAAGAATGAGTGTAAC
GGGATGAGAATGAAGCGAC -> GGATGAGAATGAAGCGACT
GGGATGAGACCAGGCGAGC -> GGATGAGACCAGGCGAGCT
GGGATGAGAGGCTGAGGAA -> GGATGAGAGGCTGAGGAAG
GGGATGAGATTTTTGCCCC -> GGATGAGATTTTTGCCCCG
GGGATTCAGTTTAACTTCA -> GGATTCAGTTTAACTTCAT
GGGCAAATGCTTTGAAATC -> GGCAAATGCTTTGAAATCC
GGGCACTGCATGCTGGCCC -> GGCACTGCATGCTGGCCCA
GGGCATCGGAGTCTTACGG -> GGCATCGGAGTCTTACGGC
GGGCCACGGCCATCCAAGT -> GGCCACGGCCATCCAAGTG
GGGCCAGTGGTACTGCCGG -> GGCCAGTGGTACTGCCGGT
GGGCCGTCAGGGCCACGGC -> GGCCGTCAGGGCCACGGCC
GGGCCTATTTAAGGTGCTC -> GGCCTATTTAAGGTGCTCT
GGGCGATCCCCTGTTCTAT -> GGCGATCCCCTGTTCTATG
GGGCGGGTCTCGGGATGAG -> GGCGGGTCTCGGGATGAGA
GGGCTCCAACTCATAAGGC -> GGCTCCAACTCATAAGGCC
GGGGATTCAGTTTAACTTC -> GGGATTCAGTTTAACTTCA
GGGGCAAATGCTTTGAAAT -> GGGCAAATGCTTTGAAATC
GGGGCACTGCATGCTGGCC -> GGGCACTGCATGCTGGCCC
GGGGCATCGGAGTCTTACG -> GGGCATCGGAGTCTTACGG
GGGGCGGGTCTCGGGATGA -> GGGCGGGTCTCGGGATGAG
GGGGGCAAATGCTTTGAAA -> GGGGCAAATGCTTTGAAAT
GGGGGGCAAATGCTTTGAA -> GGGGGCAAATGCTTTGAAA
GGGGTAGAAAAGATTTTTT -> GGGTAGAAAAGATTTTTTA
GGGTAATGATTATGTAGCG -> GGTAATGATTATGTAGCGG
GGGTACACCCATAACACCA -> GGTACACCCATAACACCAA
GGGTAGAAAAGATTTTTTA -> GGTAGAAAAGATTTTTTAT
GGGTAGCTGGAGAGTTCGG -> GGTAGCTGGAGAGTTCGGA
GGGTCCTATCGCACCGCTT -> GGTCCTATCGCACCGCTTG
GGGTCTCGGGATGAGAATG -> GGTCTCGGGATGAGAATGA
GGGTCTCGGGATGAGACCA -> GGTCTCGGGATGAGACCAG
GGGTCTCGGGATGAGAGGC -> GGTCTCGGGATGAGAGGCT
GGGTCTCGGGATGAGATTT -> GGTCTCGGGATGAGATTTT
GGGTCTGGTCAAGTTGGGT -> GGTCTGGTCAAGTTGGGTT
GGGTGAACCTCAACTCGTG -> GGTGAACCTCAACTCGTGC
GGGTGACCGGTAGCCCACC -> GGTGACCGGTAGCCCACCG
GGGTGAGAACGTTACTACT -> GGTGAGAACGTTACTACTT
GGGTGAGGATGTAACATAG -> GGTGAGGATGTAACATAGG
GGGTTCTAAGTATCACCTT -> GGTTCTAAGTATCACCTTA
GGGTTCTACGCTCCTTGCT -> GGTTCTACGCTCCTTGCTT
GGGTTCTGCAAATAGGAAT -> GGTTCTGCAAATAGGAATA
GGGTTCTTCGGGACTTCCA -> GGTTCTTCGGGACTTCCAA
GGGTTTGATTCCAAACGTA -> GGTTTGATTCCAAACGTAG
GGTAATGATTATGTAGCGG -> GTAATGATTATGTAGCGGG
GGTACACCCATAACACCAA -> GTACACCCATAACACCAAC
GGTACTGAACTGGGCCTAT -> GTACTGAACTGGGCCTATT
GGTACTGCCGGTGCAGCGC -> GTACTGCCGGTGCAGCGCC
GGTAGAAAAGATTTTTTAT -> GTAGAAAAGATTTTTTATA
GGTAGACAGACACTAGATG -> GTAGACAGACACTAGATGG
GGTAGCCCACCGTGTCGCT -> GTAGCCCACCGTGTCGCTT
GGTAGCTGGAGAGTTCGGA -> GTAGCTGGAGAGTTCGGAA
GGTATTGAAAGGGTGAGAA -> GTATTGAAAGGGTGAGAAC
GGTCAAGTTGGGTTTGATT -> GTCAAGTTGGGTTTGATTC
GGTCCATAGTGGGACGCCG -> GTCCATAGTGGGACGCCGG
GGTCCTATCGCACCGCTTG -> GTCCTATCGCACCGCTTGT
GGTCCTCTGGTGCTGGAGC -> GTCCTCTGGTGCTGGAGCG
GGTCGCACTGATACAGTCT -> GTCGCACTGATACAGTCTT
GGTCGCCTGAGTATCCGCT -> GTCGCCTGAGTATCCGCTC
GGTCGGTTTCACGCACAAC -> GTCGGTTTCACGCACAACG
GGTCTCGGGATGAGAATGA -> GTCTCGGGATGAGAATGAA
GGTCTCGGGATGAGACCAG -> GTCTCGGGATGAGACCAGG
GGTCTCGGGATGAGAGGCT -> GTCTCGGGATGAGAGGCTG
GGTCTCGGGATGAGATTTT -> GTCTCGGGATGAGATTTTT
GGTCTGGTCAAGTTGGGTT -> GTCTGGTCAAGTTGGGTTT
GGTCTGTCTGCATGGCACT -> GTCTGTCTGCATGGCACTC
GGTGAACCTCAACTCGTGC -> GTGAACCTCAACTCGTGCC
GGTGACCGGTAGCCCACCG -> GTGACCGGTAGCCCACCGT
GGTGAGAACGTTACTACTT -> GTGAGAACGTTACTACTTG
GGTGAGGATGTAACATAGG -> GTGAGGATGTAACATAGGG
GGTGAGGCTTTTGCCTGCC -> GTGAGGCTTTTGCCTGCCG
GGTGCAGCGCCGCCAAAAC -> GTGCAGCGCCGCCAAAACA
GGTGCTCTCGAGACGGGGT -> GTGCTCTCGAGACGGGGTA
GGTGCTGGAGCGGGGCGGG -> GTGCTGGAGCGGGGCGGGT
GGTGTTCGCACAGAGCACA -> GTGTTCGCACAGAGCACAA
GGTTCTAAGTATCACCTTA -> GTTCTAAGTATCACCTTAG
GGTTCTACGCTCCTTGCTT -> GTTCTACGCTCCTTGCTTA
GGTTCTCAGCCCTGGACAA -> GTTCTCAGCCCTGGACAAT
GGTTCTGCAAATAGGAATA -> GTTCTGCAAATAGGAATAT
GGTTCTTCGGGACTTCCAA -> GTTCTTCGGGACTTCCAAC
GGTTTCACGCACAACGCTA -> GTTTCACGCACAACGCTAG
GGTTTCAGCATAATCCATG -> GTTTCAGCATAATCCATGA
GGTTTGATTCCAAACGTAG -> GTTTGATTCCAAACGTAGG
GGTTTGCTAATTCAGTTCA -> GTTTGCTAATTCAGTTCAT
GTAACAAGAGACAGCACTG -> TAACAAGAGACAGCACTGT
GTAACATAGGGTGAACCTC -> TAACATAGGGTGAACCTCA
GTAACCACTGACAGAAGCT -> TAACCACTGACAGAAGCTC
GTAAGCTGATAACTTGCTT -> TAAGCTGATAACTTGCTTA
GTAAGGCCTAGGCGTCACT -> TAAGGCCTAGGCGTCACTG
GTAATGATTATGTAGCGGG -> TAATGATTATGTAGCGGGT
GTAATTTACCACGATCCAT -> TAATTTACCACGATCCATT
GTACACCCATAACACCAAC -> TACACCCATAACACCAACT
GTACATCTCTAGGACGACA -> TACATCTCTAGGACGACAA
GTACTGAACTGGGCCTATT -> TACTGAACTGGGCCTATTT
GTACTGCCGGTGCAGCGCC -> TACTGCCGGTGCAGCGCCG
GTAGAAAAGATTTTTTATA -> TAGAAAAGATTTTTTATAC
GTAGACAGACACTAGATGG -> TAGACAGACACTAGATGGC
GTAGCCATAGACAGAATGG -> TAGCCATAGACAGAATGGC
GTAGCCCACCGTGTCGCTT -> TAGCCCACCGTGTCGCTTC
GTAGCCCGGCTGATGGAGG -> TAGCCCGGCTGATGGAGGC
GTAGCGGGTCTCGGGATGA -> TAGCGGGTCTCGGGATGAG
GTAGCTCGGAGTTGTTTCG -> TAGCTCGGAGTTGTTTCGA
GTAGCTGGAGAGTTCGGAA -> TAGCTGGAGAGTTCGGAAT
GTAGGCTCGGCCAAGTATC -> TAGGCTCGGCCAAGTATCG
GTAGGGCCGTCAGGGCCAC -> TAGGGCCGTCAGGGCCACG
GTAGGTCCATAGTGGGACG -> TAGGTCCATAGTGGGACGC
GTAGGTCGCACTGATACAG -> TAGGTCGCACTGATACAGT
GTATCACCTTAGCCGGGTA -> TATCACCTTAGCCGGGTAC
GTATCCGCTCTCGTGTGGT -> TATCCGCTCTCGTGTGGTT
GTATCGTCGCACGTCTACA -> TATCGTCGCACGTCTACAG
GTATTGAAAGGGTGAGAAC -> TATTGAAAGGGTGAGAACG
GTCAAGTTGGGTTTGATTC -> TCAAGTTGGGTTTGATTCC
GTCAATTTGCAACGATTTG -> TCAATTTGCAACGATTTGG
GTCACTGACGTTAGGGTAG -> TCACTGACGTTAGGGTAGC
GTCAGCGAGGGTCCTATCG -> TCAGCGAGGGTCCTATCGC
GTCAGCTGTTTTGTTCCAG -> TCAGCTGTTTTGTTCCAGG
GTCAGGGCCACGGCCATCC -> TCAGGGCCACGGCCATCCA
GTCCAAATCATCTATAGTT -> TCCAAATCATCTATAGTTC
GTCCATAGTGGGACGCCGG -> TCCATAGTGGGACGCCGGC
GTCCCAATGCCCAGACGGC -> TCCCAATGCCCAGACGGCA
GTCCTATCGCACCGCTTGT -> TCCTATCGCACCGCTTGTT
GTCCTCTGGTGCTGGAGCG -> TCCTCTGGTGCTGGAGCGG
GTCGACCTCTAGTGGTCTG -> TCGACCTCTAGTGGTCTGT
GTCGCAATGCCCCTCATAT -> TCGCAATGCCCCTCATATC
GTCGCACGTCTACAGTCTG -> TCGCACGTCTACAGTCTGG
GTCGCACTGATACAGTCTT -> TCGCACTGATACAGTCTTG
GTCGCCCTGAACGTCGCAA -> TCGCCCTGAACGTCGCAAT
GTCGCCTGAGTATCCGCTC -> TCGCCTGAGTATCCGCTCT
GTCGCTTCCCTCAGTCCAA -> TCGCTTCCCTCAGTCCAAA
GTCGGTTTCACGCACAACG -> TCGGTTTCACGCACAACGC
GTCGTCTTAGCGAACCGCT -> TCGTCTTAGCGAACCGCTG
GTCTACAGTCTGGCGCTGA -> TCTACAGTCTGGCGCTGAG
GTCTCGGGATGAGAATGAA -> TCTCGGGATGAGAATGAAG
GTCTCGGGATGAGACCAGG -> TCTCGGGATGAGACCAGGC
GTCTCGGGATGAGAGGCTG -> TCTCGGGATGAGAGGCTGA
GTCTCGGGATGAGATTTTT -> TCTCGGGATGAGATTTTTG
GTCTGCATGGCACTCATTA -> TCTGCATGGCACTCATTAC
GTCTGGTCAAGTTGGGTTT -> TCTGGTCAAGTTGGGTTTG
GTCTGTCTGCATGGCACTC -> TCTGTCTGCATGGCACTCA
GTCTTACGGCTCCTCAGCA -> TCTTACGGCTCCTCAGCAC
GTCTTAGCGAACCGCTGCC -> TCTTAGCGAACCGCTGCCC
GTCTTGATGGAATTTGACT -> TCTTGATGGAATTTGACTA
GTGAACCTCAACTCGTGCC -> TGAACCTCAACTCGTGCCA
GTGACCGGTAGCCCACCGT -> TGACCGGTAGCCCACCGTG
GTGAGAACGTTACTACTTG -> TGAGAACGTTACTACTTGT
GTGAGGATGTAACATAGGG -> TGAGGATGTAACATAGGGT
GTGAGGCTTTTGCCTGCCG -> TGAGGCTTTTGCCTGCCGG
GTGATCTACCAATCGGATT -> TGATCTACCAATCGGATTT
GTGCACAGGGGCATCGGAG -> TGCACAGGGGCATCGGAGT
GTGCAGCGCCGCCAAAACA -> TGCAGCGCCGCCAAAACAG
GTGCCATTGATTGGTAGAC -> TGCCATTGATTGGTAGACA
GTGCGGGTCTCGGGATGAG -> TGCGGGTCTCGGGATGAGA
GTGCTCTCGAGACGGGGTA -> TGCTCTCGAGACGGGGTAG
GTGCTGGAGCGGGGCGGGT -> TGCTGGAGCGGGGCGGGTC
GTGCTGTCGTCTTAGCGAA -> TGCTGTCGTCTTAGCGAAC
GTGCTTGCTTTGCTTATTA -> TGCTTGCTTTGCTTATTAA
GTGGCTCGGGTCTGGTCAA -> TGGCTCGGGTCTGGTCAAG
GTGGGACGCCGGCTGAGGA -> TGGGACGCCGGCTGAGGAG
GTGGGTGACCGGTAGCCCA -> TGGGTGACCGGTAGCCCAC
GTGGTACTGCCGGTGCAGC -> TGGTACTGCCGGTGCAGCG
GTGGTCTGTCTGCATGGCA -> TGGTCTGTCTGCATGGCAC
GTGGTTCTCAGCCCTGGAC -> TGGTTCTCAGCCCTGGACA
GTGGTTTCAGCATAATCCA -> TGGTTTCAGCATAATCCAT
GTGTAACAAGAGACAGCAC -> TGTAACAAGAGACAGCACT
GTGTAATTTACCACGATCC -> TGTAATTTACCACGATCCA
GTGTCGACCTCTAGTGGTC -> TGTCGACCTCTAGTGGTCT
GTGTCGCTTCCCTCAGTCC -> TGTCGCTTCCCTCAGTCCA
GTGTGGTTTCAGCATAATC -> TGTGGTTTCAGCATAATCC
GTGTGTCGACCTCTAGTGG -> TGTGTCGACCTCTAGTGGT
GTGTTCGCACAGAGCACAA -> TGTTCGCACAGAGCACAAT
GTTACTACTTGTAGGCTCG -> TTACTACTTGTAGGCTCGG
GTTAGGGTAGCTGGAGAGT -> TTAGGGTAGCTGGAGAGTT
GTTATCCGTGGGTGACCGG -> TTATCCGTGGGTGACCGGT
GTTCATTCACGAGCAGCCG -> TTCATTCACGAGCAGCCGT
GTTCCAGGGCCAGTGGTAC -> TTCCAGGGCCAGTGGTACT
GTTCCTTTAGCACCTGTTG -> TTCCTTTAGCACCTGTTGA
GTTCGCACAGAGCACAATG -> TTCGCACAGAGCACAATGA
GTTCGGAATAAGAACGGCA -> TTCGGAATAAGAACGGCAG
GTTCTAAGTATCACCTTAG -> TTCTAAGTATCACCTTAGC
GTTCTACGCTCCTTGCTTA -> TTCTACGCTCCTTGCTTAT
GTTCTAGGTGAGGCTTTTG -> TTCTAGGTGAGGCTTTTGC
GTTCTATGGGGGGCAAATG -> TTCTATGGGGGGCAAATGC
GTTCTCAGCCCTGGACAAT -> TTCTCAGCCCTGGACAATT
GTTCTCCCACGCACGCGTA -> TTCTCCCACGCACGCGTAA
GTTCTGCAAATAGGAATAT -> TTCTGCAAATAGGAATATC
GTTCTTCGGGACTTCCAAC -> TTCTTCGGGACTTCCAACA
GTTGACACCGTAGGGCCGT -> TTGACACCGTAGGGCCGTC
GTTGAGGCGGCGGTCCTCT -> TTGAGGCGGCGGTCCTCTG
GTTGCGACGGCGCTAAATG -> TTGCGACGGCGCTAAATGG
GTTGGATATCTGGGTTCTA -> TTGGATATCTGGGTTCTAA,TTGGATATCTGGGTTCTAC
GTTGGATATCTGGGTTCTG -> TTGGATATCTGGGTTCTGC
GTTGGATATCTGGGTTCTT -> TTGGATATCTGGGTTCTTC
GTTGGGTTTGATTCCAAAC -> TTGGGTTTGATTCCAAACG
GTTGTTCTAGGTGAGGCTT -> TTGTTCTAGGTGAGGCTTT
GTTGTTTCGAAAAACCGAG -> TTGTTTCGAAAAACCGAGC
GTTGTTTTTCAGAGAAGCC -> TTGTTTTTCAGAGAAGCCC
GTTTAACTTCATGGTCGCC -> TTTAACTTCATGGTCGCCT
GTTTAGGAAAGTCAGCTGT -> TTTAGGAAAGTCAGCTGTT
GTTTCACGCACAACGCTAG -> TTTCACGCACAACGCTAGG
GTTTCAGCATAATCCATGA -> TTTCAGCATAATCCATGAA
GTTTCGAAAAACCGAGCAC -> TTTCGAAAAACCGAGCACG
GTTTGATTCCAAACGTAGG -> TTTGATTCCAAACGTAGGT
GTTTGCTAATTCAGTTCAT -> TTTGCTAATTCAGTTCATT
GTTTTGTTCCAGGGCCAGT -> TTTTGTTCCAGGGCCAGTG
GTTTTTCAGAGAAGCCCCC -> TTTTTCAGAGAAGCCCCCC
TAAATGGCAGCAGAGGGTG -> AAATGGCAGCAGAGGGTGA
TAACAAGAGACAGCACTGT -> AACAAGAGACAGCACTGTT
TAACACCAACTGCTTCTTT -> AACACCAACTGCTTCTTTG
TAACATAGGGTGAACCTCA -> AACATAGGGTGAACCTCAA
TAACCACTGACAGAAGCTC -> AACCACTGACAGAAGCTCA
TAACGGAGCGATCTCAAAC -> AACGGAGCGATCTCAAACG
TAACTCCAATAACGGAGCG -> AACTCCAATAACGGAGCGA
TAACTGCAGAACAACCTTT -> AACTGCAGAACAACCTTTG
TAACTTCATGGTCGCCTGA -> AACTTCATGGTCGCCTGAG
TAACTTGCTTACATGTCAA -> AACTTGCTTACATGTCAAT
TAAGAACGGCAGAGCCTAT -> AAGAACGGCAGAGCCTATA
TAAGAATGAGTGTAACAAG -> AAGAATGAGTGTAACAAGA
TAAGCTGATAACTTGCTTA -> AAGCTGATAACTTGCTTAC
TAAGGCCGACAGTGCTTGC -> AAGGCCGACAGTGCTTGCT
TAAGGCCTAGGCGTCACTG -> AAGGCCTAGGCGTCACTGA
TAAGGGACGCTTTGGAGAA -> AAGGGACGCTTTGGAGAAT
TAAGGTGCTCTCGAGACGG -> AAGGTGCTCTCGAGACGGG
TAAGTATCACCTTAGCCGG -> AAGTATCACCTTAGCCGGG
TAATAATTGGATTGAAGAC -> AATAATTGGATTGAAGACA
TAATAGACGGACCGGCAGT -> AATAGACGGACCGGCAGTC
TAATATAGTGTAATTTACC -> AATATAGTGTAATTTACCA
TAATCCATGAAACCGGCTG -> AATCCATGAAACCGGCTGA
TAATCGCCGAGATATCCGA -> AATCGCCGAGATATCCGAG
TAATGATTATGTAGCGGGT -> AATGATTATGTAGCGGGTC
TAATTCAGTTCATTCACGA -> AATTCAGTTCATTCACGAG
TAATTGGATTGAAGACAAT -> AATTGGATTGAAGACAATC
TAATTTACCACGATCCATT -> AATTTACCACGATCCATTG
TAATTTACCCGGACACCAG -> AATTTACCCGGACACCAGG
TACACCCATAACACCAACT -> ACACCCATAACACCAACTG
TACAGTCTGGCGCTGAGGG -> ACAGTCTGGCGCTGAGGGT
TACAGTCTTGATGGAATTT -> ACAGTCTTGATGGAATTTG
TACATCTCTAGGACGACAA -> ACATCTCTAGGACGACAAA
TACATGTCAATTTGCAACG -> ACATGTCAATTTGCAACGA
TACCAAAGAGTTCCTTTAG -> ACCAAAGAGTTCCTTTAGC
TACCAAATGCGTTGTTTTT -> ACCAAATGCGTTGTTTTTC
TACCAAATTTCCGACTGTT -> ACCAAATTTCCGACTGTTG
TACCAATCGGATTTGAGAC -> ACCAATCGGATTTGAGACA
TACCACGATCCATTGTACA -> ACCACGATCCATTGTACAT
TACCCGGACACCAGGGTAA -> ACCCGGACACCAGGGTAAT
TACCCTTATTAATAGACGG -> ACCCTTATTAATAGACGGA
TACCGCTACCAAATGCGTT -> ACCGCTACCAAATGCGTTG
TACGATAGGGATAAGAATG -> ACGATAGGGATAAGAATGA
TACGCGTCCCAATGCCCAG -> ACGCGTCCCAATGCCCAGA
TACGCTCCTTGCTTATAGC -> ACGCTCCTTGCTTATAGCA
TACGGCTCCTCAGCACCCA -> ACGGCTCCTCAGCACCCAT
TACGGGCTCCAACTCATAA -> ACGGGCTCCAACTCATAAG
TACTAATATAGTGTAATTT -> ACTAATATAGTGTAATTTA
TACTACTTGTAGGCTCGGC -> ACTACTTGTAGGCTCGGCC
TACTCAGGCGGGGATTCAG -> ACTCAGGCGGGGATTCAGT
TACTGAACTGGGCCTATTT -> ACTGAACTGGGCCTATTTA
TACTGCCGGTGCAGCGCCG -> ACTGCCGGTGCAGCGCCGC
TACTTGTAGGCTCGGCCAA -> ACTTGTAGGCTCGGCCAAG
TAGAAAAGATTTTTTATAC -> AGAAAAGATTTTTTATACC
TAGACAGAATGGCGAACCA -> AGACAGAATGGCGAACCAG
TAGACAGACACTAGATGGC -> AGACAGACACTAGATGGCT
TAGACGGACCGGCAGTCGC -> AGACGGACCGGCAGTCGCC
TAGATGGCTACCAAAGAGT -> AGATGGCTACCAAAGAGTT
TAGCACCCATTATTTCCAG -> AGCACCCATTATTTCCAGC
TAGCACCTGTTGACACCGT -> AGCACCTGTTGACACCGTA
TAGCCATAGACAGAATGGC -> AGCCATAGACAGAATGGCG
TAGCCCACCGTGTCGCTTC -> AGCCCACCGTGTCGCTTCC
TAGCCCGGCTGATGGAGGC -> AGCCCGGCTGATGGAGGCC
TAGCCGGGTACACCCATAA -> AGCCGGGTACACCCATAAC
TAGCGAACCGCTGCCCACC -> AGCGAACCGCTGCCCACCT
TAGCGGGTCTCGGGATGAG -> AGCGGGTCTCGGGATGAGA
TAGCTCGGAGTTGTTTCGA -> AGCTCGGAGTTGTTTCGAA
TAGCTGGAGAGTTCGGAAT -> AGCTGGAGAGTTCGGAATA
TAGGAAAGTCAGCTGTTTT -> AGGAAAGTCAGCTGTTTTG
TAGGAACACACTCCAGGAA -> AGGAACACACTCCAGGAAT
TAGGAATATCACCGCATGA -> AGGAATATCACCGCATGAT
TAGGACGACAAAAGGGGCA -> AGGACGACAAAAGGGGCAC
TAGGCGATACTAATATAGT -> AGGCGATACTAATATAGTG
TAGGCGTCACTGACGTTAG -> AGGCGTCACTGACGTTAGG
TAGGCTCGGCCAAGTATCG -> AGGCTCGGCCAAGTATCGT
TAGGGACAGAAAACTCTAC -> AGGGACAGAAAACTCTACC
TAGGGATAAGAATGAGTGT -> AGGGATAAGAATGAGTGTA
TAGGGCCGTCAGGGCCACG -> AGGGCCGTCAGGGCCACGG
TAGGGTAGCTGGAGAGTTC -> AGGGTAGCTGGAGAGTTCG
TAGGGTGAACCTCAACTCG -> AGGGTGAACCTCAACTCGT
TAGGTACTGAACTGGGCCT -> AGGTACTGAACTGGGCCTA
TAGGTCCATAGTGGGACGC -> AGGTCCATAGTGGGACGCC
TAGGTCGCACTGATACAGT -> AGGTCGCACTGATACAGTC
TAGGTGAGGCTTTTGCCTG -> AGGTGAGGCTTTTGCCTGC
TAGTGCGGGTCTCGGGATG -> AGTGCGGGTCTCGGGATGA
TAGTGGGACGCCGGCTGAG -> AGTGGGACGCCGGCTGAGG
TAGTGGTCTGTCTGCATGG -> AGTGGTCTGTCTGCATGGC
TAGTGTAATTTACCACGAT -> AGTGTAATTTACCACGATC
TAGTTCTCCCACGCACGCG -> AGTTCTCCCACGCACGCGT
TATAAGGGACGCTTTGGAG -> ATAAGGGACGCTTTGGAGA
TATACCCTTATTAATAGAC -> ATACCCTTATTAATAGACG
TATAGCACCCATTATTTCC -> ATAGCACCCATTATTTCCA
TATAGGTACTGAACTGGGC -> ATAGGTACTGAACTGGGCC
TATAGTGTAATTTACCACG -> ATAGTGTAATTTACCACGA
TATAGTTCTCCCACGCACG -> ATAGTTCTCCCACGCACGC
TATCACCGCATGATCCATT -> ATCACCGCATGATCCATTA
TATCACCTTAGCCGGGTAC -> ATCACCTTAGCCGGGTACA
TATCCGAGTAGCTCGGAGT -> ATCCGAGTAGCTCGGAGTT
TATCCGCTCTCGTGTGGTT -> ATCCGCTCTCGTGTGGTTT
TATCCGTGGGTGACCGGTA -> ATCCGTGGGTGACCGGTAG
TATCGCAAACCATCATAGG -> ATCGCAAACCATCATAGGA
TATCGCACCGCTTGTTATC -> ATCGCACCGCTTGTTATCC
TATCGTCGCACGTCTACAG -> ATCGTCGCACGTCTACAGT
TATCTACGGGCTCCAACTC -> ATCTACGGGCTCCAACTCA
TATCTGGGTTCTAAGTATC -> ATCTGGGTTCTAAGTATCA
TATCTGGGTTCTACGCTCC -> ATCTGGGTTCTACGCTCCT
TATCTGGGTTCTGCAAATA -> ATCTGGGTTCTGCAAATAG
TATCTGGGTTCTTCGGGAC -> ATCTGGGTTCTTCGGGACT
TATGCATGAACGGCTCATA -> ATGCATGAACGGCTCATAT
TATGGGGGGCAAATGCTTT -> ATGGGGGGCAAATGCTTTG
TATGTAGCGGGTCTCGGGA -> ATGTAGCGGGTCTCGGGAT
TATTAATAGACGGACCGGC -> ATTAATAGACGGACCGGCA
TATTAATCGCCGAGATATC -> ATTAATCGCCGAGATATCC
TATTATAGGTACTGAACTG -> ATTATAGGTACTGAACTGG
TATTGAAAGGGTGAGAACG -> ATTGAAAGGGTGAGAACGT
TATTTAAGGTGCTCTCGAG -> ATTTAAGGTGCTCTCGAGA
TATTTCCAGCGAGGTGTTC -> ATTTCCAGCGAGGTGTTCG
TCAAACGCGACTCTACCAA -> CAAACGCGACTCTACCAAA
TCAACCTTCACGAGGCAAA -> CAACCTTCACGAGGCAAAG
TCAACTCGTGCCATTGATT -> CAACTCGTGCCATTGATTG
TCAAGTTGGGTTTGATTCC -> CAAGTTGGGTTTGATTCCA
TCAATTTGCAACGATTTGG -> CAATTTGCAACGATTTGGT
TCACCCCGAACGACCCTAC -> CACCCCGAACGACCCTACG
TCACCGCATGATCCATTAA -> CACCGCATGATCCATTAAC
TCACCTTAGCCGGGTACAC -> CACCTTAGCCGGGTACACC
TCACGAGCAGCCGTCAGCG -> CACGAGCAGCCGTCAGCGA
TCACGAGGCAAAGTAGCCC -> CACGAGGCAAAGTAGCCCG
TCACGCACAACGCTAGGCG -> CACGCACAACGCTAGGCGA
TCACTGACGTTAGGGTAGC -> CACTGACGTTAGGGTAGCT
TCAGAGAAGCCCCCCTGTA -> CAGAGAAGCCCCCCTGTAA
TCAGCACCCATTTGACTAT -> CAGCACCCATTTGACTATG
TCAGCATAATCCATGAAAC -> CAGCATAATCCATGAAACC
TCAGCCCTGGACAATTTGA -> CAGCCCTGGACAATTTGAT
TCAGCGAGGGTCCTATCGC -> CAGCGAGGGTCCTATCGCA
TCAGCTGTTTTGTTCCAGG -> CAGCTGTTTTGTTCCAGGG
TCAGGCGGGGATTCAGTTT -> CAGGCGGGGATTCAGTTTA
TCAGGGCCACGGCCATCCA -> CAGGGCCACGGCCATCCAA
TCAGTCCAAATCATCTATA -> CAGTCCAAATCATCTATAG
TCAGTTCATTCACGAGCAG -> CAGTTCATTCACGAGCAGC
TCAGTTTAACTTCATGGTC -> CAGTTTAACTTCATGGTCG
TCATAAGGCCGACAGTGCT -> CATAAGGCCGACAGTGCTT
TCATAGGAACACACTCCAG -> CATAGGAACACACTCCAGG
TCATATCGCAAACCATCAT -> CATATCGCAAACCATCATA
TCATATCTACGGGCTCCAA -> CATATCTACGGGCTCCAAC
TCATCACCCCGAACGACCC -> CATCACCCCGAACGACCCT
TCATCTATAGTTCTCCCAC -> CATCTATAGTTCTCCCACG
TCATGAGTAGCCATAGACA -> CATGAGTAGCCATAGACAG
TCATGGTCGCCTGAGTATC -> CATGGTCGCCTGAGTATCC
TCATTACGCGTCCCAATGC -> CATTACGCGTCCCAATGCC
TCATTCACGAGCAGCCGTC -> CATTCACGAGCAGCCGTCA
TCATTTAATAATTGGATTG -> CATTTAATAATTGGATTGA
TCCAAACGTAGGTCCATAG -> CCAAACGTAGGTCCATAGT
TCCAAATCATCTATAGTTC -> CCAAATCATCTATAGTTCT
TCCAACAACCCTGGCCGGT -> CCAACAACCCTGGCCGGTC
TCCAACTCATAAGGCCGAC -> CCAACTCATAAGGCCGACA
TCCAAGTGTGTCGACCTCT -> CCAAGTGTGTCGACCTCTA
TCCAATAACGGAGCGATCT -> CCAATAACGGAGCGATCTC
TCCAATCATGAGTAGCCAT -> CCAATCATGAGTAGCCATA
TCCAGCGAGGTGTTCGCAC -> CCAGCGAGGTGTTCGCACA
TCCAGGAATCATCACCCCG -> CCAGGAATCATCACCCCGA
TCCAGGGCCAGTGGTACTG -> CCAGGGCCAGTGGTACTGC
TCCATAGTGGGACGCCGGC -> CCATAGTGGGACGCCGGCT
TCCATGAAACCGGCTGATG -> CCATGAAACCGGCTGATGT
TCCATTAACTCCAATAACG -> CCATTAACTCCAATAACGG
TCCATTGTACATCTCTAGG -> CCATTGTACATCTCTAGGA
TCCCAATGCCCAGACGGCA -> CCCAATGCCCAGACGGCAT
TCCCACGCACGCGTAACCA -> CCCACGCACGCGTAACCAC
TCCCCTGTTCTATGGGGGG -> CCCCTGTTCTATGGGGGGC
TCCCTCAGTCCAAATCATC -> CCCTCAGTCCAAATCATCT
TCCCTTGTTGTTCTAGGTG -> CCCTTGTTGTTCTAGGTGA
TCCGACTGTTGCGACGGCG -> CCGACTGTTGCGACGGCGC
TCCGAGTAGCTCGGAGTTG -> CCGAGTAGCTCGGAGTTGT
TCCGATGATTTGCGTGCTG -> CCGATGATTTGCGTGCTGT
TCCGCTCTCGTGTGGTTTC -> CCGCTCTCGTGTGGTTTCA
TCCGTGGGTGACCGGTAGC -> CCGTGGGTGACCGGTAGCC
TCCTATCGCACCGCTTGTT -> CCTATCGCACCGCTTGTTA
TCCTATTATAGGTACTGAA -> CCTATTATAGGTACTGAAC
TCCTCAGCACCCATTTGAC -> CCTCAGCACCCATTTGACT
TCCTCTGGTGCTGGAGCGG -> CCTCTGGTGCTGGAGCGGG
TCCTTGCTTATAGCACCCA -> CCTTGCTTATAGCACCCAT
TCCTTTAGCACCTGTTGAC -> CCTTTAGCACCTGTTGACA
TCGAAAAACCGAGCACGGC -> CGAAAAACCGAGCACGGCA
TCGACCTCTAGTGGTCTGT -> CGACCTCTAGTGGTCTGTC
TCGAGACGGGGTAGAAAAG -> CGAGACGGGGTAGAAAAGA
TCGCAAACCATCATAGGAA -> CGCAAACCATCATAGGAAC
TCGCAATGCCCCTCATATC -> CGCAATGCCCCTCATATCT
TCGCACAGAGCACAATGAA -> CGCACAGAGCACAATGAAG
TCGCACCGCTTGTTATCCG -> CGCACCGCTTGTTATCCGT
TCGCACGTCTACAGTCTGG -> CGCACGTCTACAGTCTGGC
TCGCACTGATACAGTCTTG -> CGCACTGATACAGTCTTGA
TCGCCCTGAACGTCGCAAT -> CGCCCTGAACGTCGCAATG
TCGCCGAGATATCCGAGTA -> CGCCGAGATATCCGAGTAG
TCGCCTGAGTATCCGCTCT -> CGCCTGAGTATCCGCTCTC
TCGCTTCCCTCAGTCCAAA -> CGCTTCCCTCAGTCCAAAT
TCGGAATAAGAACGGCAGA -> CGGAATAAGAACGGCAGAG
TCGGAGTCTTACGGCTCCT -> CGGAGTCTTACGGCTCCTC
TCGGAGTTGTTTCGAAAAA -> CGGAGTTGTTTCGAAAAAC
TCGGATTTGAGACAGCCGT -> CGGATTTGAGACAGCCGTA
TCGGCCAAGTATCGTCGCA -> CGGCCAAGTATCGTCGCAC
TCGGCTAGTGCGGGTCTCG -> CGGCTAGTGCGGGTCTCGG
TCGGGACTTCCAACAACCC -> CGGGACTTCCAACAACCCT
TCGGGATGAGAATGAAGCG -> CGGGATGAGAATGAAGCGA
TCGGGATGAGACCAGGCGA -> CGGGATGAGACCAGGCGAG
TCGGGATGAGAGGCTGAGG -> CGGGATGAGAGGCTGAGGA
TCGGGATGAGATTTTTGCC -> CGGGATGAGATTTTTGCCC
TCGGGTCTGGTCAAGTTGG -> CGGGTCTGGTCAAGTTGGG
TCGGTTTCACGCACAACGC -> CGGTTTCACGCACAACGCT
TCGGTTTGCTAATTCAGTT -> CGGTTTGCTAATTCAGTTC
TCGTCGCACGTCTACAGTC -> CGTCGCACGTCTACAGTCT
TCGTCTTAGCGAACCGCTG -> CGTCTTAGCGAACCGCTGC
TCGTGCCATTGATTGGTAG -> CGTGCCATTGATTGGTAGA
TCGTGTGGTTTCAGCATAA -> CGTGTGGTTTCAGCATAAT
TCGTTGGATATCTGGGTTC -> CGTTGGATATCTGGGTTCT,CGTTGGATATCTGGGTTCT
TCTAAGTATCACCTTAGCC -> CTAAGTATCACCTTAGCCG
TCTACAGTCTGGCGCTGAG -> CTACAGTCTGGCGCTGAGG
TCTACCAAATTTCCGACTG -> CTACCAAATTTCCGACTGT
TCTACCAATCGGATTTGAG -> CTACCAATCGGATTTGAGA
TCTACCGCTACCAAATGCG -> CTACCGCTACCAAATGCGT
TCTACGCTCCTTGCTTATA -> CTACGCTCCTTGCTTATAG
TCTACGGGCTCCAACTCAT -> CTACGGGCTCCAACTCATA
TCTAGGACGACAAAAGGGG -> CTAGGACGACAAAAGGGGC
TCTAGGTGAGGCTTTTGCC -> CTAGGTGAGGCTTTTGCCT
TCTAGTGGTCTGTCTGCAT -> CTAGTGGTCTGTCTGCATG
TCTATAGTTCTCCCACGCA -> CTATAGTTCTCCCACGCAC
TCTATGGGGGGCAAATGCT -> CTATGGGGGGCAAATGCTT
TCTCAAACGCGACTCTACC -> CTCAAACGCGACTCTACCA
TCTCAGCCCTGGACAATTT -> CTCAGCCCTGGACAATTTG
TCTCCCACGCACGCGTAAC -> CTCCCACGCACGCGTAACC
TCTCGAGACGGGGTAGAAA -> CTCGAGACGGGGTAGAAAA
TCTCGGGATGAGAATGAAG -> CTCGGGATGAGAATGAAGC
TCTCGGGATGAGACCAGGC -> CTCGGGATGAGACCAGGCG
TCTCGGGATGAGAGGCTGA -> CTCGGGATGAGAGGCTGAG
TCTCGGGATGAGATTTTTG -> CTCGGGATGAGATTTTTGC
TCTCGTGTGGTTTCAGCAT -> CTCGTGTGGTTTCAGCATA
TCTCTAGGACGACAAAAGG -> CTCTAGGACGACAAAAGGG
TCTGCAAATAGGAATATCA -> CTGCAAATAGGAATATCAC
TCTGCATGGCACTCATTAC -> CTGCATGGCACTCATTACG
TCTGGGTTCTAAGTATCAC -> CTGGGTTCTAAGTATCACC
TCTGGGTTCTACGCTCCTT -> CTGGGTTCTACGCTCCTTG
TCTGGGTTCTGCAAATAGG -> CTGGGTTCTGCAAATAGGA
TCTGGGTTCTTCGGGACTT -> CTGGGTTCTTCGGGACTTC
TCTGGTCAAGTTGGGTTTG -> CTGGTCAAGTTGGGTTTGA
TCTGGTGCTGGAGCGGGGC -> CTGGTGCTGGAGCGGGGCG
TCTGTCTGCATGGCACTCA -> CTGTCTGCATGGCACTCAT
TCTTACGGCTCCTCAGCAC -> CTTACGGCTCCTCAGCACC
TCTTAGCGAACCGCTGCCC -> CTTAGCGAACCGCTGCCCA
TCTTCGGGACTTCCAACAA -> CTTCGGGACTTCCAACAAC
TCTTGATGGAATTTGACTA -> CTTGATGGAATTTGACTAA
TCTTTGCCATGTGATCTAC -> CTTTGCCATGTGATCTACC
TCTTTTCGGCTAGTGCGGG -> CTTTTCGGCTAGTGCGGGT
TGAAACCGGCTGATGTGGC -> GAAACCGGCTGATGTGGCT
TGAAAGCTCCAATCATGAG -> GAAAGCTCCAATCATGAGT
TGAAAGGGTGAGAACGTTA -> GAAAGGGTGAGAACGTTAC
TGAAATCCTATTATAGGTA -> GAAATCCTATTATAGGTAC
TGAACCTCAACTCGTGCCA -> GAACCTCAACTCGTGCCAT
TGAACGGCTCATATCGCAA -> GAACGGCTCATATCGCAAA
TGAACGTCGCAATGCCCCT -> GAACGTCGCAATGCCCCTC
TGAACTGGGCCTATTTAAG -> GAACTGGGCCTATTTAAGG
TGAAGACAATCGGTTTGCT -> GAAGACAATCGGTTTGCTA
TGAAGCGACTCGTTGGATA -> GAAGCGACTCGTTGGATAT
TGAAGCGGCCGATTTGCAG -> GAAGCGGCCGATTTGCAGG
TGACACCGTAGGGCCGTCA -> GACACCGTAGGGCCGTCAG
TGACAGAAGCTCAACCTTC -> GACAGAAGCTCAACCTTCA
TGACCGGTAGCCCACCGTG -> GACCGGTAGCCCACCGTGT
TGACGTTAGGGTAGCTGGA -> GACGTTAGGGTAGCTGGAG
TGACTAACTGCAGAACAAC -> GACTAACTGCAGAACAACC
TGACTATGCATGAACGGCT -> GACTATGCATGAACGGCTC
TGAGAACGTTACTACTTGT -> GAGAACGTTACTACTTGTA
TGAGAATGAAGCGACTCGT -> GAGAATGAAGCGACTCGTT
TGAGACAGCCGTAAGGCCT -> GAGACAGCCGTAAGGCCTA
TGAGACCAGGCGAGCTCGT -> GAGACCAGGCGAGCTCGTT
TGAGAGGCTGAGGAAGCGT -> GAGAGGCTGAGGAAGCGTT
TGAGATTTTTGCCCCGCGT -> GAGATTTTTGCCCCGCGTT
TGAGGAAGCGTTGGATATC -> GAGGAAGCGTTGGATATCT
TGAGGAGCTTAGGGACAGA -> GAGGAGCTTAGGGACAGAA
TGAGGATGTAACATAGGGT -> GAGGATGTAACATAGGGTG
TGAGGCGGCGGTCCTCTGG -> GAGGCGGCGGTCCTCTGGT
TGAGGCTTTTGCCTGCCGG -> GAGGCTTTTGCCTGCCGGC
TGAGTAGCCATAGACAGAA -> GAGTAGCCATAGACAGAAT
TGAGTATCCGCTCTCGTGT -> GAGTATCCGCTCTCGTGTG
TGAGTGTAACAAGAGACAG -> GAGTGTAACAAGAGACAGC
TGATAACTTGCTTACATGT -> GATAACTTGCTTACATGTC
TGATACAGTCTTGATGGAA -> GATACAGTCTTGATGGAAT
TGATCCATTAACTCCAATA -> GATCCATTAACTCCAATAA
TGATCTACCAATCGGATTT -> GATCTACCAATCGGATTTG
TGATGGAATTTGACTAACT -> GATGGAATTTGACTAACTG
TGATGGAGGCCCGCGGGTC -> GATGGAGGCCCGCGGGTCT
TGATGTGGCTCGGGTCTGG -> GATGTGGCTCGGGTCTGGT
TGATTAATTTACCCGGACA -> GATTAATTTACCCGGACAC
TGATTATGTAGCGGGTCTC -> GATTATGTAGCGGGTCTCG
TGATTCCAAACGTAGGTCC -> GATTCCAAACGTAGGTCCA
TGATTGGTAGACAGACACT -> GATTGGTAGACAGACACTA
TGATTTGCGTGCTGTCGTC -> GATTTGCGTGCTGTCGTCT
TGCAAATAGGAATATCACC -> GCAAATAGGAATATCACCG
TGCAACGATTTGGTATTGA -> GCAACGATTTGGTATTGAA
TGCACAGGGGCATCGGAGT -> GCACAGGGGCATCGGAGTC
TGCAGAACAACCTTTGAAA -> GCAGAACAACCTTTGAAAG
TGCAGCGCCGCCAAAACAG -> GCAGCGCCGCCAAAACAGA
TGCAGGGCGATCCCCTGTT -> GCAGGGCGATCCCCTGTTC
TGCATGAACGGCTCATATC -> GCATGAACGGCTCATATCG
TGCATGCTGGCCCAGTAGG -> GCATGCTGGCCCAGTAGGT
TGCATGGCACTCATTACGC -> GCATGGCACTCATTACGCG
TGCCATGTGATCTACCAAT -> GCCATGTGATCTACCAATC
TGCCATTGATTGGTAGACA -> GCCATTGATTGGTAGACAG
TGCCCACCTGCTGTGGTTC -> GCCCACCTGCTGTGGTTCT
TGCCCAGACGGCATCCCTT -> GCCCAGACGGCATCCCTTG
TGCCCCGCGTTGGATATCT -> GCCCCGCGTTGGATATCTG
TGCCCCTCATATCTACGGG -> GCCCCTCATATCTACGGGC
TGCCGGCCCTCCGATGATT -> GCCGGCCCTCCGATGATTT
TGCCGGTGCAGCGCCGCCA -> GCCGGTGCAGCGCCGCCAA
TGCCTGCCGGCCCTCCGAT -> GCCTGCCGGCCCTCCGATG
TGCGACGGCGCTAAATGGC -> GCGACGGCGCTAAATGGCA
TGCGGGTCTCGGGATGAGA -> GCGGGTCTCGGGATGAGAT
TGCGTGCTGTCGTCTTAGC -> GCGTGCTGTCGTCTTAGCG
TGCGTTGTTTTTCAGAGAA -> GCGTTGTTTTTCAGAGAAG
TGCTAATTCAGTTCATTCA -> GCTAATTCAGTTCATTCAC
TGCTCTCGAGACGGGGTAG -> GCTCTCGAGACGGGGTAGA
TGCTGGAGCGGGGCGGGTC -> GCTGGAGCGGGGCGGGTCT
TGCTGGCCCAGTAGGTCGC -> GCTGGCCCAGTAGGTCGCA
TGCTGTCGTCTTAGCGAAC -> GCTGTCGTCTTAGCGAACC
TGCTGTGGTTCTCAGCCCT -> GCTGTGGTTCTCAGCCCTG
TGCTTACATGTCAATTTGC -> GCTTACATGTCAATTTGCA
TGCTTATAGCACCCATTAT -> GCTTATAGCACCCATTATT
TGCTTATTAATCGCCGAGA -> GCTTATTAATCGCCGAGAT
TGCTTCTTTGCCATGTGAT -> GCTTCTTTGCCATGTGATC
TGCTTGCTTTGCTTATTAA -> GCTTGCTTTGCTTATTAAT
TGCTTTGAAATCCTATTAT -> GCTTTGAAATCCTATTATA
TGCTTTGCTTATTAATCGC -> GCTTTGCTTATTAATCGCC
TGGAATTTGACTAACTGCA -> GGAATTTGACTAACTGCAG
TGGACAATTTGATTAATTT -> GGACAATTTGATTAATTTA
TGGAGAATGTTTAGGAAAG -> GGAGAATGTTTAGGAAAGT
TGGAGAGTTCGGAATAAGA -> GGAGAGTTCGGAATAAGAA
TGGAGCGGGGCGGGTCTCG -> GGAGCGGGGCGGGTCTCGG
TGGAGGCCCGCGGGTCTCG -> GGAGGCCCGCGGGTCTCGG
TGGATATCTGGGTTCTAAG -> GGATATCTGGGTTCTAAGT
TGGATATCTGGGTTCTACG -> GGATATCTGGGTTCTACGC
TGGATATCTGGGTTCTGCA -> GGATATCTGGGTTCTGCAA
TGGATATCTGGGTTCTTCG -> GGATATCTGGGTTCTTCGG
TGGATTGAAGACAATCGGT -> GGATTGAAGACAATCGGTT
TGGCACTCATTACGCGTCC -> GGCACTCATTACGCGTCCC
TGGCAGCAGAGGGTGAGGA -> GGCAGCAGAGGGTGAGGAT
TGGCCCAGTAGGTCGCACT -> GGCCCAGTAGGTCGCACTG
TGGCCGGTCGGTTTCACGC -> GGCCGGTCGGTTTCACGCA
TGGCGAACCAGTGCACAGG -> GGCGAACCAGTGCACAGGG
TGGCTACCAAAGAGTTCCT -> GGCTACCAAAGAGTTCCTT
TGGCTCGGGTCTGGTCAAG -> GGCTCGGGTCTGGTCAAGT
TGGGACGCCGGCTGAGGAG -> GGGACGCCGGCTGAGGAGC
TGGGCCTATTTAAGGTGCT -> GGGCCTATTTAAGGTGCTC
TGGGGGGCAAATGCTTTGA -> GGGGGGCAAATGCTTTGAA
TGGGTGACCGGTAGCCCAC -> GGGTGACCGGTAGCCCACC
TGGGTTCTAAGTATCACCT -> GGGTTCTAAGTATCACCTT
TGGGTTCTACGCTCCTTGC -> GGGTTCTACGCTCCTTGCT
TGGGTTCTGCAAATAGGAA -> GGGTTCTGCAAATAGGAAT
TGGGTTCTTCGGGACTTCC -> GGGTTCTTCGGGACTTCCA
TGGGTTTGATTCCAAACGT -> GGGTTTGATTCCAAACGTA
TGGTACTGCCGGTGCAGCG -> GGTACTGCCGGTGCAGCGC
TGGTAGACAGACACTAGAT -> GGTAGACAGACACTAGATG
TGGTATTGAAAGGGTGAGA -> GGTATTGAAAGGGTGAGAA
TGGTCAAGTTGGGTTTGAT -> GGTCAAGTTGGGTTTGATT
TGGTCGCCTGAGTATCCGC -> GGTCGCCTGAGTATCCGCT
TGGTCTGTCTGCATGGCAC -> GGTCTGTCTGCATGGCACT
TGGTGCTGGAGCGGGGCGG -> GGTGCTGGAGCGGGGCGGG
TGGTTCTCAGCCCTGGACA -> GGTTCTCAGCCCTGGACAA
TGGTTTCAGCATAATCCAT -> GGTTTCAGCATAATCCATG
TGTAACAAGAGACAGCACT -> GTAACAAGAGACAGCACTG
TGTAACATAGGGTGAACCT -> GTAACATAGGGTGAACCTC
TGTAAGCTGATAACTTGCT -> GTAAGCTGATAACTTGCTT
TGTAATTTACCACGATCCA -> GTAATTTACCACGATCCAT
TGTACATCTCTAGGACGAC -> GTACATCTCTAGGACGACA
TGTAGCGGGTCTCGGGATG -> GTAGCGGGTCTCGGGATGA
TGTAGGCTCGGCCAAGTAT -> GTAGGCTCGGCCAAGTATC
TGTCAATTTGCAACGATTT -> GTCAATTTGCAACGATTTG
TGTCGACCTCTAGTGGTCT -> GTCGACCTCTAGTGGTCTG
TGTCGCTTCCCTCAGTCCA -> GTCGCTTCCCTCAGTCCAA
TGTCGTCTTAGCGAACCGC -> GTCGTCTTAGCGAACCGCT
TGTCTGCATGGCACTCATT -> GTCTGCATGGCACTCATTA
TGTGATCTACCAATCGGAT -> GTGATCTACCAATCGGATT
TGTGGCTCGGGTCTGGTCA -> GTGGCTCGGGTCTGGTCAA
TGTGGTTCTCAGCCCTGGA -> GTGGTTCTCAGCCCTGGAC
TGTGGTTTCAGCATAATCC -> GTGGTTTCAGCATAATCCA
TGTGTCGACCTCTAGTGGT -> GTGTCGACCTCTAGTGGTC
TGTTATCCGTGGGTGACCG -> GTTATCCGTGGGTGACCGG
TGTTCCAGGGCCAGTGGTA -> GTTCCAGGGCCAGTGGTAC
TGTTCGCACAGAGCACAAT -> GTTCGCACAGAGCACAATG
TGTTCTAGGTGAGGCTTTT -> GTTCTAGGTGAGGCTTTTG
TGTTCTATGGGGGGCAAAT -> GTTCTATGGGGGGCAAATG
TGTTGACACCGTAGGGCCG -> GTTGACACCGTAGGGCCGT
TGTTGAGGCGGCGGTCCTC -> GTTGAGGCGGCGGTCCTCT
TGTTGCGACGGCGCTAAAT -> GTTGCGACGGCGCTAAATG
TGTTGTTCTAGGTGAGGCT -> GTTGTTCTAGGTGAGGCTT
TGTTTAGGAAAGTCAGCTG -> GTTTAGGAAAGTCAGCTGT
TGTTTCGAAAAACCGAGCA -> GTTTCGAAAAACCGAGCAC
TGTTTTGTTCCAGGGCCAG -> GTTTTGTTCCAGGGCCAGT
TGTTTTTCAGAGAAGCCCC -> GTTTTTCAGAGAAGCCCCC
TTAACTCCAATAACGGAGC -> TAACTCCAATAACGGAGCG
TTAACTTCATGGTCGCCTG -> TAACTTCATGGTCGCCTGA
TTAAGGTGCTCTCGAGACG -> TAAGGTGCTCTCGAGACGG
TTAATAATTGGATTGAAGA -> TAATAATTGGATTGAAGAC
TTAATAGACGGACCGGCAG -> TAATAGACGGACCGGCAGT
TTAATCGCCGAGATATCCG -> TAATCGCCGAGATATCCGA
TTAATTTACCCGGACACCA -> TAATTTACCCGGACACCAG
TTACATGTCAATTTGCAAC -> TACATGTCAATTTGCAACG
TTACCACGATCCATTGTAC -> TACCACGATCCATTGTACA
TTACCCGGACACCAGGGTA -> TACCCGGACACCAGGGTAA
TTACGCGTCCCAATGCCCA -> TACGCGTCCCAATGCCCAG
TTACGGCTCCTCAGCACCC -> TACGGCTCCTCAGCACCCA
TTACTACTTGTAGGCTCGG -> TACTACTTGTAGGCTCGGC
TTAGCACCTGTTGACACCG -> TAGCACCTGTTGACACCGT
TTAGCCGGGTACACCCATA -> TAGCCGGGTACACCCATAA
TTAGCGAACCGCTGCCCAC -> TAGCGAACCGCTGCCCACC
TTAGGAAAGTCAGCTGTTT -> TAGGAAAGTCAGCTGTTTT
TTAGGGACAGAAAACTCTA -> TAGGGACAGAAAACTCTAC
TTAGGGTAGCTGGAGAGTT -> TAGGGTAGCTGGAGAGTTC
TTATACCCTTATTAATAGA -> TATACCCTTATTAATAGAC
TTATAGCACCCATTATTTC -> TATAGCACCCATTATTTCC
TTATAGGTACTGAACTGGG -> TATAGGTACTGAACTGGGC
TTATCCGTGGGTGACCGGT -> TATCCGTGGGTGACCGGTA
TTATGTAGCGGGTCTCGGG -> TATGTAGCGGGTCTCGGGA
TTATTAATAGACGGACCGG -> TATTAATAGACGGACCGGC
TTATTAATCGCCGAGATAT -> TATTAATCGCCGAGATATC
TTATTTCCAGCGAGGTGTT -> TATTTCCAGCGAGGTGTTC
TTCACGAGCAGCCGTCAGC -> TCACGAGCAGCCGTCAGCG
TTCACGAGGCAAAGTAGCC -> TCACGAGGCAAAGTAGCCC
TTCACGCACAACGCTAGGC -> TCACGCACAACGCTAGGCG
TTCAGAGAAGCCCCCCTGT -> TCAGAGAAGCCCCCCTGTA
TTCAGCATAATCCATGAAA -> TCAGCATAATCCATGAAAC
TTCAGTTCATTCACGAGCA -> TCAGTTCATTCACGAGCAG
TTCAGTTTAACTTCATGGT -> TCAGTTTAACTTCATGGTC
TTCATGGTCGCCTGAGTAT -> TCATGGTCGCCTGAGTATC
TTCATTCACGAGCAGCCGT -> TCATTCACGAGCAGCCGTC
TTCCAAACGTAGGTCCATA -> TCCAAACGTAGGTCCATAG
TTCCAACAACCCTGGCCGG -> TCCAACAACCCTGGCCGGT
TTCCAGCGAGGTGTTCGCA -> TCCAGCGAGGTGTTCGCAC
TTCCAGGGCCAGTGGTACT -> TCCAGGGCCAGTGGTACTG
TTCCCTCAGTCCAAATCAT -> TCCCTCAGTCCAAATCATC
TTCCGACTGTTGCGACGGC -> TCCGACTGTTGCGACGGCG
TTCCTTTAGCACCTGTTGA -> TCCTTTAGCACCTGTTGAC
TTCGAAAAACCGAGCACGG -> TCGAAAAACCGAGCACGGC
TTCGCACAGAGCACAATGA -> TCGCACAGAGCACAATGAA
TTCGGAATAAGAACGGCAG -> TCGGAATAAGAACGGCAGA
TTCGGCTAGTGCGGGTCTC -> TCGGCTAGTGCGGGTCTCG
TTCGGGACTTCCAACAACC -> TCGGGACTTCCAACAACCC
TTCTAAGTATCACCTTAGC -> TCTAAGTATCACCTTAGCC
TTCTACGCTCCTTGCTTAT -> TCTACGCTCCTTGCTTATA
TTCTAGGTGAGGCTTTTGC -> TCTAGGTGAGGCTTTTGCC
TTCTATGGGGGGCAAATGC -> TCTATGGGGGGCAAATGCT
TTCTCAGCCCTGGACAATT -> TCTCAGCCCTGGACAATTT
TTCTCCCACGCACGCGTAA -> TCTCCCACGCACGCGTAAC
TTCTGCAAATAGGAATATC -> TCTGCAAATAGGAATATCA
TTCTTCGGGACTTCCAACA -> TCTTCGGGACTTCCAACAA
TTCTTTGCCATGTGATCTA -> TCTTTGCCATGTGATCTAC
TTGAAAGCTCCAATCATGA -> TGAAAGCTCCAATCATGAG
TTGAAAGGGTGAGAACGTT -> TGAAAGGGTGAGAACGTTA
TTGAAATCCTATTATAGGT -> TGAAATCCTATTATAGGTA
TTGAAGACAATCGGTTTGC -> TGAAGACAATCGGTTTGCT
TTGACACCGTAGGGCCGTC -> TGACACCGTAGGGCCGTCA
TTGACTAACTGCAGAACAA -> TGACTAACTGCAGAACAAC
TTGACTATGCATGAACGGC -> TGACTATGCATGAACGGCT
TTGAGACAGCCGTAAGGCC -> TGAGACAGCCGTAAGGCCT
TTGAGGCGGCGGTCCTCTG -> TGAGGCGGCGGTCCTCTGG
TTGATGGAATTTGACTAAC -> TGATGGAATTTGACTAACT
TTGATTAATTTACCCGGAC -> TGATTAATTTACCCGGACA
TTGATTCCAAACGTAGGTC -> TGATTCCAAACGTAGGTCC
TTGATTGGTAGACAGACAC -> TGATTGGTAGACAGACACT
TTGCAACGATTTGGTATTG -> TGCAACGATTTGGTATTGA
TTGCAGGGCGATCCCCTGT -> TGCAGGGCGATCCCCTGTT
TTGCCATGTGATCTACCAA -> TGCCATGTGATCTACCAAT
TTGCCCCGCGTTGGATATC -> TGCCCCGCGTTGGATATCT
TTGCCTGCCGGCCCTCCGA -> TGCCTGCCGGCCCTCCGAT
TTGCGACGGCGCTAAATGG -> TGCGACGGCGCTAAATGGC
TTGCGTGCTGTCGTCTTAG -> TGCGTGCTGTCGTCTTAGC
TTGCTAATTCAGTTCATTC -> TGCTAATTCAGTTCATTCA
TTGCTTACATGTCAATTTG -> TGCTTACATGTCAATTTGC
TTGCTTATAGCACCCATTA -> TGCTTATAGCACCCATTAT
TTGCTTATTAATCGCCGAG -> TGCTTATTAATCGCCGAGA
TTGCTTTGCTTATTAATCG -> TGCTTTGCTTATTAATCGC
TTGGAGAATGTTTAGGAAA -> TGGAGAATGTTTAGGAAAG
TTGGATATCTGGGTTCTAA -> TGGATATCTGGGTTCTAAG
TTGGATATCTGGGTTCTAC -> TGGATATCTGGGTTCTACG
TTGGATATCTGGGTTCTGC -> TGGATATCTGGGTTCTGCA
TTGGATATCTGGGTTCTTC -> TGGATATCTGGGTTCTTCG
TTGGATTGAAGACAATCGG -> TGGATTGAAGACAATCGGT
TTGGGTTTGATTCCAAACG -> TGGGTTTGATTCCAAACGT
TTGGTAGACAGACACTAGA -> TGGTAGACAGACACTAGAT
TTGGTATTGAAAGGGTGAG -> TGGTATTGAAAGGGTGAGA
TTGTACATCTCTAGGACGA -> TGTACATCTCTAGGACGAC
TTGTAGGCTCGGCCAAGTA -> TGTAGGCTCGGCCAAGTAT
TTGTTATCCGTGGGTGACC -> TGTTATCCGTGGGTGACCG
TTGTTCCAGGGCCAGTGGT -> TGTTCCAGGGCCAGTGGTA
TTGTTCTAGGTGAGGCTTT -> TGTTCTAGGTGAGGCTTTT
TTGTTGTTCTAGGTGAGGC -> TGTTGTTCTAGGTGAGGCT
TTGTTTCGAAAAACCGAGC -> TGTTTCGAAAAACCGAGCA
TTGTTTTTCAGAGAAGCCC -> TGTTTTTCAGAGAAGCCCC
TTTAACTTCATGGTCGCCT -> TTAACTTCATGGTCGCCTG
TTTAAGGTGCTCTCGAGAC -> TTAAGGTGCTCTCGAGACG
TTTAATAATTGGATTGAAG -> TTAATAATTGGATTGAAGA
TTTACCACGATCCATTGTA -> TTACCACGATCCATTGTAC
TTTACCCGGACACCAGGGT -> TTACCCGGACACCAGGGTA
TTTAGCACCTGTTGACACC -> TTAGCACCTGTTGACACCG
TTTAGGAAAGTCAGCTGTT -> TTAGGAAAGTCAGCTGTTT
TTTATACCCTTATTAATAG -> TTATACCCTTATTAATAGA
TTTCACGCACAACGCTAGG -> TTCACGCACAACGCTAGGC
TTTCAGAGAAGCCCCCCTG -> TTCAGAGAAGCCCCCCTGT
TTTCAGCATAATCCATGAA -> TTCAGCATAATCCATGAAA
TTTCCAGCGAGGTGTTCGC -> TTCCAGCGAGGTGTTCGCA
TTTCCGACTGTTGCGACGG -> TTCCGACTGTTGCGACGGC
TTTCGAAAAACCGAGCACG -> TTCGAAAAACCGAGCACGG
TTTCGGCTAGTGCGGGTCT -> TTCGGCTAGTGCGGGTCTC
TTTGAAAGCTCCAATCATG -> TTGAAAGCTCCAATCATGA
TTTGAAATCCTATTATAGG -> TTGAAATCCTATTATAGGT
TTTGACTAACTGCAGAACA -> TTGACTAACTGCAGAACAA
TTTGACTATGCATGAACGG -> TTGACTATGCATGAACGGC
TTTGAGACAGCCGTAAGGC -> TTGAGACAGCCGTAAGGCC
TTTGATTAATTTACCCGGA -> TTGATTAATTTACCCGGAC
TTTGATTCCAAACGTAGGT -> TTGATTCCAAACGTAGGTC
TTTGCAACGATTTGGTATT -> TTGCAACGATTTGGTATTG
TTTGCAGGGCGATCCCCTG -> TTGCAGGGCGATCCCCTGT
TTTGCCATGTGATCTACCA -> TTGCCATGTGATCTACCAA
TTTGCCCCGCGTTGGATAT -> TTGCCCCGCGTTGGATATC
TTTGCCTGCCGGCCCTCCG -> TTGCCTGCCGGCCCTCCGA
TTTGCGTGCTGTCGTCTTA -> TTGCGTGCTGTCGTCTTAG
TTTGCTAATTCAGTTCATT -> TTGCTAATTCAGTTCATTC
TTTGCTTATTAATCGCCGA -> TTGCTTATTAATCGCCGAG
TTTGGAGAATGTTTAGGAA -> TTGGAGAATGTTTAGGAAA
TTTGGTATTGAAAGGGTGA -> TTGGTATTGAAAGGGTGAG
TTTGTTCCAGGGCCAGTGG -> TTGTTCCAGGGCCAGTGGT
TTTTATACCCTTATTAATA -> TTTATACCCTTATTAATAG
TTTTCAGAGAAGCCCCCCT -> TTTCAGAGAAGCCCCCCTG
TTTTCGGCTAGTGCGGGTC -> TTTCGGCTAGTGCGGGTCT
TTTTGCCCCGCGTTGGATA -> TTTGCCCCGCGTTGGATAT
TTTTGCCTGCCGGCCCTCC -> TTTGCCTGCCGGCCCTCCG
TTTTGTTCCAGGGCCAGTG -> TTTGTTCCAGGGCCAGTGG
TTTTTATACCCTTATTAAT -> TTTTATACCCTTATTAATA
TTTTTCAGAGAAGCCCCCC -> TTTTCAGAGAAGCCCCCCT
TTTTTGCCCCGCGTTGGAT -> TTTTGCCCCGCGTTGGATA
TTTTTTATACCCTTATTAA -> TTTTTATACCCTTATTAAT